matchId,time_sec,minute,blue_gold,red_gold,diff
KR_7777147221,0.0,0.0,7000,7000,0
KR_7777147221,60.013,1.0,7015,7015,0
KR_7777147221,120.028,2.0,9243,9419,-176
KR_7777147221,180.112,3.0,12024,12393,-369
KR_7777147221,240.133,4.0,16775,15826,949
KR_7777147221,300.149,5.0,19533,19747,-214
KR_7777147221,360.168,6.0,22745,23817,-1072
KR_7777147221,420.183,7.0,25022,26194,-1172
KR_7777147221,480.202,8.0,27857,29255,-1398
KR_7777147221,540.208,9.0,30462,33511,-3049
KR_7777147221,600.232,10.0,33696,36557,-2861
KR_7777147221,660.258,11.0,36260,39803,-3543
KR_7777147221,720.291,12.0,38524,42664,-4140
KR_7777147221,780.31,13.01,44240,45809,-1569
KR_7777147221,840.343,14.01,46662,48832,-2170
KR_7777147221,900.374,15.01,49214,52391,-3177
KR_7777147221,960.395,16.01,51542,56183,-4641
KR_7777147221,1019.628,16.99,54141,59035,-4894
KR_7775267167,0.0,0.0,7000,7000,0
KR_7775267167,60.012,1.0,7015,7015,0
KR_7775267167,120.025,2.0,11347,10424,923
KR_7775267167,180.102,3.0,15418,13720,1698
KR_7775267167,240.119,4.0,18444,17075,1369
KR_7775267167,300.122,5.0,21580,20450,1130
KR_7775267167,360.137,6.0,24563,23077,1486
KR_7775267167,420.154,7.0,28351,27818,533
KR_7775267167,480.178,8.0,32138,31031,1107
KR_7775267167,540.18,9.0,35325,34676,649
KR_7775267167,600.213,10.0,38197,37827,370
KR_7775267167,660.246,11.0,41957,40171,1786
KR_7775267167,720.27,12.0,44220,42810,1410
KR_7775267167,780.284,13.0,46576,46010,566
KR_7775267167,840.3,14.0,49962,50006,-44
KR_7775267167,900.331,15.01,53551,53282,269
KR_7775267167,960.362,16.01,56870,56237,633
KR_7775267167,1020.363,17.01,60170,59342,828
KR_7775267167,1080.381,18.01,62682,62043,639
KR_7775267167,1140.383,19.01,65811,67068,-1257
KR_7775267167,1200.404,20.01,68721,69567,-846
KR_7775267167,1260.424,21.01,70748,75191,-4443
KR_7775267167,1260.591,21.01,70748,75191,-4443
KR_7750298473,0.0,0.0,7000,7000,0
KR_7750298473,60.019,1.0,7015,7015,0
KR_7750298473,120.047,2.0,9426,9285,141
KR_7750298473,141.558,2.36,10161,10921,-760
KR_7772050971,0.0,0.0,7000,7000,0
KR_7772050971,60.02,1.0,7025,7015,10
KR_7772050971,120.029,2.0,9907,10133,-226
KR_7772050971,180.049,3.0,13053,13487,-434
KR_7772050971,240.053,4.0,15787,16764,-977
KR_7772050971,300.072,5.0,20165,19665,500
KR_7772050971,360.096,6.0,24217,24723,-506
KR_7772050971,420.184,7.0,26424,27517,-1093
KR_7772050971,480.202,8.0,29380,30218,-838
KR_7772050971,540.217,9.0,33127,33575,-448
KR_7772050971,600.235,10.0,36192,36291,-99
KR_7772050971,660.262,11.0,39512,40400,-888
KR_7772050971,720.28,12.0,44667,42908,1759
KR_7772050971,780.29,13.0,48183,45538,2645
KR_7772050971,840.312,14.01,52050,49389,2661
KR_7772050971,900.319,15.01,54553,52052,2501
KR_7772050971,957.232,15.95,57754,54351,3403
KR_7740309635,0.0,0.0,7000,7000,0
KR_7740309635,60.018,1.0,7015,7015,0
KR_7740309635,120.023,2.0,10446,9851,595
KR_7740309635,180.041,3.0,14412,13238,1174
KR_7740309635,240.073,4.0,18067,17024,1043
KR_7740309635,300.092,5.0,21929,20541,1388
KR_7740309635,360.114,6.0,25300,23732,1568
KR_7740309635,420.202,7.0,28606,28202,404
KR_7740309635,480.217,8.0,32654,31408,1246
KR_7740309635,540.222,9.0,35733,34802,931
KR_7740309635,600.226,10.0,38409,37155,1254
KR_7740309635,660.227,11.0,42409,40386,2023
KR_7740309635,720.233,12.0,45083,45021,62
KR_7740309635,780.239,13.0,49161,48186,975
KR_7740309635,840.27,14.0,51656,51960,-304
KR_7740309635,900.28,15.0,55664,56001,-337
KR_7740309635,960.294,16.0,58399,58650,-251
KR_7740309635,1020.325,17.01,62423,61531,892
KR_7740309635,1080.339,18.01,64644,64561,83
KR_7740309635,1140.36,19.01,66892,69107,-2215
KR_7740309635,1141.061,19.02,66907,69122,-2215
KR_7733035584,0.0,0.0,7000,7000,0
KR_7733035584,60.024,1.0,7015,7437,-422
KR_7733035584,120.025,2.0,9610,10269,-659
KR_7733035584,180.039,3.0,12848,12942,-94
KR_7733035584,240.039,4.0,16856,17734,-878
KR_7733035584,300.052,5.0,19578,20709,-1131
KR_7733035584,360.061,6.0,23418,24496,-1078
KR_7733035584,420.077,7.0,26003,27673,-1670
KR_7733035584,480.088,8.0,30156,31465,-1309
KR_7733035584,540.13,9.0,32756,34844,-2088
KR_7733035584,600.152,10.0,35976,37352,-1376
KR_7733035584,660.203,11.0,39396,41530,-2134
KR_7733035584,720.228,12.0,42194,44894,-2700
KR_7733035584,780.229,13.0,45344,48917,-3573
KR_7733035584,840.254,14.0,48809,51797,-2988
KR_7733035584,900.286,15.0,51713,55049,-3336
KR_7733035584,960.294,16.0,54609,58833,-4224
KR_7733035584,1020.324,17.01,58113,61651,-3538
KR_7733035584,1080.349,18.01,61744,65010,-3266
KR_7733035584,1140.377,19.01,64885,67695,-2810
KR_7733035584,1200.403,20.01,67972,71874,-3902
KR_7733035584,1260.416,21.01,70943,74156,-3213
KR_7733035584,1320.44,22.01,75610,77146,-1536
KR_7733035584,1380.451,23.01,78071,80966,-2895
KR_7733035584,1440.461,24.01,81773,83251,-1478
KR_7733035584,1498.607,24.98,84085,87406,-3321
KR_7731612124,0.0,0.0,7000,7000,0
KR_7731612124,60.004,1.0,7427,7015,412
KR_7731612124,120.034,2.0,10566,10560,6
KR_7731612124,180.11,3.0,14109,13155,954
KR_7731612124,240.14,4.0,17065,16307,758
KR_7731612124,300.173,5.0,20099,19304,795
KR_7731612124,360.194,6.0,23753,22058,1695
KR_7731612124,420.201,7.0,27699,24777,2922
KR_7731612124,480.224,8.0,30898,28692,2206
KR_7731612124,540.242,9.0,35399,32085,3314
KR_7731612124,600.243,10.0,38393,34571,3822
KR_7731612124,660.262,11.0,41809,37910,3899
KR_7731612124,720.29,12.0,45134,40897,4237
KR_7731612124,780.314,13.01,47831,45026,2805
KR_7731612124,840.34,14.01,51886,48111,3775
KR_7731612124,900.363,15.01,54333,52308,2025
KR_7731612124,960.388,16.01,56933,54502,2431
KR_7731612124,1020.418,17.01,61321,56955,4366
KR_7731612124,1080.439,18.01,64876,58999,5877
KR_7731612124,1080.606,18.01,64876,58999,5877
KR_7769845102,0.0,0.0,7000,7000,0
KR_7769845102,60.011,1.0,7015,7015,0
KR_7769845102,120.014,2.0,10448,9044,1404
KR_7769845102,180.037,3.0,12969,11242,1727
KR_7769845102,223.104,3.72,15872,12615,3257
KR_7773445355,0.0,0.0,7000,7000,0
KR_7773445355,60.018,1.0,7015,7015,0
KR_7773445355,120.039,2.0,9831,9528,303
KR_7773445355,180.124,3.0,12704,11975,729
KR_7773445355,240.151,4.0,16605,15132,1473
KR_7773445355,300.171,5.0,20797,18160,2637
KR_7773445355,360.19,6.0,23665,21772,1893
KR_7773445355,420.193,7.0,26892,24050,2842
KR_7773445355,480.217,8.0,30637,27396,3241
KR_7773445355,540.229,9.0,34660,30042,4618
KR_7773445355,600.256,10.0,37221,32878,4343
KR_7773445355,660.267,11.0,40693,35895,4798
KR_7773445355,720.295,12.0,44293,38849,5444
KR_7773445355,780.302,13.01,46569,41717,4852
KR_7773445355,840.324,14.01,50840,45169,5671
KR_7773445355,900.338,15.01,54426,48430,5996
KR_7773445355,960.348,16.01,58241,51914,6327
KR_7773445355,1020.36,17.01,62244,55048,7196
KR_7773445355,1080.371,18.01,65386,57759,7627
KR_7773445355,1127.905,18.8,67972,60129,7843
KR_7766459476,0.0,0.0,7000,7000,0
KR_7766459476,60.031,1.0,7015,7015,0
KR_7766459476,120.053,2.0,10323,10135,188
KR_7766459476,180.149,3.0,12908,13255,-347
KR_7766459476,240.177,4.0,16145,16125,20
KR_7766459476,300.178,5.0,19740,19812,-72
KR_7766459476,360.207,6.0,22372,22783,-411
KR_7766459476,420.217,7.0,25292,26345,-1053
KR_7766459476,480.24,8.0,29174,29391,-217
KR_7766459476,540.257,9.0,32559,32813,-254
KR_7766459476,600.267,10.0,35987,36108,-121
KR_7766459476,660.284,11.0,39074,39198,-124
KR_7766459476,720.293,12.0,43792,42518,1274
KR_7766459476,780.308,13.01,46416,45129,1287
KR_7766459476,840.308,14.01,50066,48947,1119
KR_7766459476,900.314,15.01,53140,51783,1357
KR_7766459476,960.342,16.01,57225,54556,2669
KR_7766459476,1020.372,17.01,60062,58130,1932
KR_7766459476,1080.39,18.01,63104,61680,1424
KR_7766459476,1140.411,19.01,67254,64087,3167
KR_7766459476,1200.421,20.01,70876,68287,2589
KR_7766459476,1260.435,21.01,74135,71067,3068
KR_7766459476,1320.453,22.01,77834,73356,4478
KR_7766459476,1334.151,22.24,78328,73776,4552
KR_7628766865,0.0,0.0,7000,7000,0
KR_7628766865,60.028,1.0,7015,7015,0
KR_7628766865,120.043,2.0,10143,10821,-678
KR_7628766865,180.107,3.0,13526,14429,-903
KR_7628766865,240.129,4.0,16462,17461,-999
KR_7628766865,300.134,5.0,19802,21046,-1244
KR_7628766865,360.156,6.0,23759,24793,-1034
KR_7628766865,420.183,7.0,26394,27040,-646
KR_7628766865,480.21,8.0,28756,31149,-2393
KR_7628766865,540.216,9.0,33304,34440,-1136
KR_7628766865,600.241,10.0,37803,36538,1265
KR_7628766865,660.271,11.0,40393,40331,62
KR_7628766865,720.3,12.0,44102,43302,800
KR_7628766865,780.302,13.01,48586,45829,2757
KR_7628766865,840.324,14.01,51836,49712,2124
KR_7628766865,900.329,15.01,55621,51964,3657
KR_7628766865,918.272,15.3,57023,53296,3727
KR_7767133480,0.0,0.0,7000,7000,0
KR_7767133480,60.006,1.0,7015,7035,-20
KR_7767133480,120.009,2.0,9742,9751,-9
KR_7767133480,180.029,3.0,13259,12359,900
KR_7767133480,240.046,4.0,16521,16907,-386
KR_7767133480,300.134,5.0,19242,19951,-709
KR_7767133480,360.135,6.0,23513,24744,-1231
KR_7767133480,420.156,7.0,26913,29960,-3047
KR_7767133480,480.178,8.0,30819,33622,-2803
KR_7767133480,540.2,9.0,34624,37739,-3115
KR_7767133480,600.228,10.0,37032,40938,-3906
KR_7767133480,660.232,11.0,40462,45075,-4613
KR_7767133480,720.252,12.0,44291,48696,-4405
KR_7767133480,780.279,13.0,47012,51550,-4538
KR_7767133480,840.282,14.0,50910,54700,-3790
KR_7767133480,900.294,15.0,54001,57958,-3957
KR_7767133480,960.316,16.01,57311,61969,-4658
KR_7767133480,1020.337,17.01,60277,64149,-3872
KR_7767133480,1080.361,18.01,63008,67744,-4736
KR_7767133480,1140.394,19.01,66550,70332,-3782
KR_7767133480,1200.396,20.01,70358,74310,-3952
KR_7767133480,1260.398,21.01,75037,77101,-2064
KR_7767133480,1320.422,22.01,78544,79313,-769
KR_7767133480,1380.453,23.01,81746,81758,-12
KR_7767133480,1440.472,24.01,85179,85374,-195
KR_7767133480,1500.473,25.01,87400,89527,-2127
KR_7767133480,1526.905,25.45,88686,91789,-3103
KR_7644770469,0.0,0.0,7000,7000,0
KR_7644770469,60.013,1.0,7030,7015,15
KR_7644770469,120.019,2.0,9914,9918,-4
KR_7644770469,180.043,3.0,13706,13672,34
KR_7644770469,240.056,4.0,16428,15989,439
KR_7644770469,300.142,5.0,18846,19533,-687
KR_7644770469,360.169,6.0,22938,22401,537
KR_7644770469,420.176,7.0,26390,26227,163
KR_7644770469,480.179,8.0,30251,30050,201
KR_7644770469,540.198,9.0,33793,32567,1226
KR_7644770469,600.228,10.0,36612,35900,712
KR_7644770469,660.248,11.0,39739,38954,785
KR_7644770469,720.277,12.0,43422,42939,483
KR_7644770469,780.28,13.0,47007,46459,548
KR_7644770469,840.295,14.0,50826,49319,1507
KR_7644770469,900.295,15.0,54716,52592,2124
KR_7644770469,960.319,16.01,57421,55514,1907
KR_7644770469,1020.351,17.01,61662,58014,3648
KR_7644770469,1080.354,18.01,65572,61954,3618
KR_7644770469,1140.357,19.01,69050,66770,2280
KR_7644770469,1200.366,20.01,72513,69611,2902
KR_7644770469,1233.353,20.56,75470,70704,4766
KR_7765836595,0.0,0.0,7000,7000,0
KR_7765836595,60.021,1.0,7015,7015,0
KR_7765836595,120.035,2.0,10297,9530,767
KR_7765836595,180.054,3.0,13645,12397,1248
KR_7765836595,240.055,4.0,16432,15599,833
KR_7765836595,300.074,5.0,19014,18987,27
KR_7765836595,360.1,6.0,21945,22289,-344
KR_7765836595,420.175,7.0,26627,25582,1045
KR_7765836595,480.205,8.0,29737,29998,-261
KR_7765836595,540.207,9.0,32617,32334,283
KR_7765836595,600.236,10.0,35578,35160,418
KR_7765836595,660.249,11.0,39050,39205,-155
KR_7765836595,720.272,12.0,42203,41741,462
KR_7765836595,780.284,13.0,45342,45243,99
KR_7765836595,840.314,14.01,48890,49114,-224
KR_7765836595,900.34,15.01,51214,51892,-678
KR_7765836595,960.369,16.01,53731,54947,-1216
KR_7765836595,1020.372,17.01,57101,59186,-2085
KR_7765836595,1080.401,18.01,62050,61358,692
KR_7765836595,1140.416,19.01,64730,65061,-331
KR_7765836595,1200.432,20.01,68510,67716,794
KR_7765836595,1260.443,21.01,71489,70256,1233
KR_7765836595,1320.461,22.01,73630,74202,-572
KR_7765836595,1380.49,23.01,77799,78442,-643
KR_7765836595,1440.517,24.01,80527,81023,-496
KR_7765836595,1500.539,25.01,83210,85056,-1846
KR_7765836595,1524.228,25.4,83915,85980,-2065
KR_7777234707,0.0,0.0,7000,7000,0
KR_7777234707,60.009,1.0,7533,7472,61
KR_7777234707,120.034,2.0,10493,11319,-826
KR_7777234707,180.113,3.0,12911,13962,-1051
KR_7777234707,240.13,4.0,16019,16303,-284
KR_7777234707,300.139,5.0,19383,19688,-305
KR_7777234707,360.162,6.0,22914,22732,182
KR_7777234707,420.174,7.0,25517,25738,-221
KR_7777234707,480.19,8.0,28466,29459,-993
KR_7777234707,540.221,9.0,32382,32035,347
KR_7777234707,600.231,10.0,35607,35753,-146
KR_7777234707,660.252,11.0,38325,39354,-1029
KR_7777234707,720.268,12.0,40739,42170,-1431
KR_7777234707,780.299,13.0,45867,44270,1597
KR_7777234707,840.31,14.01,48470,47119,1351
KR_7777234707,900.335,15.01,51636,50871,765
KR_7777234707,960.336,16.01,54122,53329,793
KR_7777234707,1020.368,17.01,56698,57139,-441
KR_7777234707,1080.379,18.01,60287,61551,-1264
KR_7777234707,1140.402,19.01,64323,64001,322
KR_7777234707,1200.423,20.01,67787,68694,-907
KR_7777234707,1260.435,21.01,70948,71305,-357
KR_7777234707,1313.713,21.9,72565,74947,-2382
KR_7729603340,0.0,0.0,7000,7000,0
KR_7729603340,60.012,1.0,7015,7015,0
KR_7729603340,120.029,2.0,9538,10732,-1194
KR_7729603340,180.103,3.0,13673,13774,-101
KR_7729603340,240.124,4.0,17602,17818,-216
KR_7729603340,300.144,5.0,21169,20631,538
KR_7729603340,360.173,6.0,24467,24307,160
KR_7729603340,420.179,7.0,27947,27887,60
KR_7729603340,480.2,8.0,31088,30793,295
KR_7729603340,540.217,9.0,34608,34735,-127
KR_7729603340,600.241,10.0,38585,38592,-7
KR_7729603340,660.254,11.0,41009,44283,-3274
KR_7729603340,720.276,12.0,45053,47570,-2517
KR_7729603340,780.292,13.0,48803,50680,-1877
KR_7729603340,840.321,14.01,52180,54090,-1910
KR_7729603340,900.331,15.01,56151,57989,-1838
KR_7729603340,960.358,16.01,59327,61198,-1871
KR_7729603340,1020.368,17.01,62989,64900,-1911
KR_7729603340,1080.388,18.01,65918,67177,-1259
KR_7729603340,1118.145,18.64,67081,70212,-3131
KR_7769100970,0.0,0.0,7000,7000,0
KR_7769100970,60.026,1.0,7015,7015,0
KR_7769100970,120.05,2.0,9649,9740,-91
KR_7769100970,180.128,3.0,12223,13161,-938
KR_7769100970,240.154,4.0,14979,16202,-1223
KR_7769100970,300.181,5.0,18181,19699,-1518
KR_7769100970,360.207,6.0,21480,21969,-489
KR_7769100970,420.216,7.0,25348,26167,-819
KR_7769100970,480.246,8.0,28820,28944,-124
KR_7769100970,540.278,9.0,31419,32238,-819
KR_7769100970,600.311,10.01,34578,34660,-82
KR_7769100970,660.33,11.01,37726,39678,-1952
KR_7769100970,720.345,12.01,41894,42546,-652
KR_7769100970,780.35,13.01,44523,44996,-473
KR_7769100970,840.357,14.01,47475,49203,-1728
KR_7769100970,900.371,15.01,50777,51606,-829
KR_7769100970,960.402,16.01,54590,55844,-1254
KR_7769100970,1020.422,17.01,58325,58996,-671
KR_7769100970,1080.428,18.01,61625,61985,-360
KR_7769100970,1140.448,19.01,64273,64469,-196
KR_7769100970,1200.471,20.01,66209,68651,-2442
KR_7769100970,1260.474,21.01,68831,73633,-4802
KR_7769100970,1262.578,21.04,68891,73693,-4802
KR_7749217671,0.0,0.0,7000,7000,0
KR_7749217671,60.017,1.0,7015,7015,0
KR_7749217671,120.022,2.0,9774,9666,108
KR_7749217671,180.038,3.0,12351,12107,244
KR_7749217671,240.045,4.0,14751,14542,209
KR_7749217671,300.062,5.0,18607,17340,1267
KR_7749217671,360.063,6.0,22517,21866,651
KR_7749217671,420.082,7.0,25859,24938,921
KR_7749217671,480.087,8.0,28995,27476,1519
KR_7749217671,540.104,9.0,31735,30903,832
KR_7749217671,600.124,10.0,35420,35327,93
KR_7749217671,660.194,11.0,37727,37727,0
KR_7749217671,720.211,12.0,42698,40211,2487
KR_7749217671,780.214,13.0,45404,45194,210
KR_7749217671,840.231,14.0,49261,47746,1515
KR_7749217671,900.265,15.0,52458,51608,850
KR_7749217671,960.271,16.0,55256,55258,-2
KR_7749217671,1020.305,17.01,59119,57933,1186
KR_7749217671,1080.321,18.01,61476,60651,825
KR_7749217671,1140.33,19.01,64263,64355,-92
KR_7749217671,1200.348,20.01,67401,67377,24
KR_7749217671,1260.359,21.01,70101,70997,-896
KR_7749217671,1320.378,22.01,72723,73506,-783
KR_7749217671,1380.385,23.01,77415,76599,816
KR_7749217671,1440.406,24.01,80739,80629,110
KR_7749217671,1500.432,25.01,84335,82947,1388
KR_7749217671,1533.21,25.55,88032,84993,3039
KR_7753245172,0.0,0.0,7000,7000,0
KR_7753245172,60.002,1.0,7015,7015,0
KR_7753245172,120.012,2.0,9312,9453,-141
KR_7753245172,180.027,3.0,11810,11986,-176
KR_7753245172,240.048,4.0,14224,14398,-174
KR_7753245172,300.121,5.0,17734,18832,-1098
KR_7753245172,360.137,6.0,21523,21374,149
KR_7753245172,420.139,7.0,25307,26568,-1261
KR_7753245172,480.171,8.0,28499,30408,-1909
KR_7753245172,540.195,9.0,31393,33128,-1735
KR_7753245172,600.208,10.0,35101,36879,-1778
KR_7753245172,660.22,11.0,38150,40544,-2394
KR_7753245172,720.234,12.0,41837,43540,-1703
KR_7753245172,780.25,13.0,44180,46532,-2352
KR_7753245172,840.282,14.0,46978,49745,-2767
KR_7753245172,900.297,15.0,49515,52601,-3086
KR_7753245172,960.3,16.0,54048,55629,-1581
KR_7753245172,1020.332,17.01,57160,59156,-1996
KR_7753245172,1080.35,18.01,60835,61793,-958
KR_7753245172,1140.364,19.01,64080,66437,-2357
KR_7753245172,1200.378,20.01,68938,68778,160
KR_7753245172,1260.392,21.01,70972,72220,-1248
KR_7753245172,1320.398,22.01,74707,75600,-893
KR_7753245172,1380.429,23.01,76891,79560,-2669
KR_7753245172,1416.278,23.6,78122,83412,-5290
KR_7733010286,0.0,0.0,7000,7000,0
KR_7733010286,60.02,1.0,7015,7015,0
KR_7733010286,120.044,2.0,10025,10076,-51
KR_7733010286,180.108,3.0,12593,12521,72
KR_7733010286,240.12,4.0,15540,15076,464
KR_7733010286,300.144,5.0,17992,18858,-866
KR_7733010286,360.171,6.0,22366,22543,-177
KR_7733010286,420.198,7.0,25051,27243,-2192
KR_7733010286,480.21,8.0,28836,29734,-898
KR_7733010286,540.215,9.0,31909,32611,-702
KR_7733010286,600.226,10.0,36063,36592,-529
KR_7733010286,660.25,11.0,39665,41339,-1674
KR_7733010286,720.262,12.0,43281,44666,-1385
KR_7733010286,780.265,13.0,45602,48318,-2716
KR_7733010286,840.276,14.0,49521,51054,-1533
KR_7733010286,900.278,15.0,52522,54879,-2357
KR_7733010286,960.282,16.0,55980,56984,-1004
KR_7733010286,1020.289,17.0,58679,61471,-2792
KR_7733010286,1080.307,18.01,62272,64620,-2348
KR_7733010286,1140.339,19.01,64673,68134,-3461
KR_7733010286,1200.352,20.01,68131,71153,-3022
KR_7733010286,1260.366,21.01,70304,75505,-5201
KR_7733010286,1275.928,21.27,71160,77742,-6582
KR_7769162602,0.0,0.0,7000,7000,0
KR_7769162602,60.014,1.0,7427,7363,64
KR_7769162602,120.029,2.0,11982,11614,368
KR_7769162602,180.104,3.0,14911,14888,23
KR_7769162602,240.128,4.0,19160,18415,745
KR_7769162602,300.149,5.0,22195,22087,108
KR_7769162602,360.169,6.0,25254,26120,-866
KR_7769162602,420.182,7.0,29159,29246,-87
KR_7769162602,480.183,8.0,33771,33766,5
KR_7769162602,540.208,9.0,36290,36850,-560
KR_7769162602,600.214,10.0,39044,40508,-1464
KR_7769162602,660.24,11.0,41968,43096,-1128
KR_7769162602,720.27,12.0,46499,47101,-602
KR_7769162602,780.297,13.0,48948,50387,-1439
KR_7769162602,840.303,14.01,51908,54202,-2294
KR_7769162602,900.327,15.01,55500,56505,-1005
KR_7769162602,960.341,16.01,57772,61227,-3455
KR_7769162602,972.032,16.2,58117,62372,-4255
KR_7706393682,0.0,0.0,7000,7000,0
KR_7706393682,60.016,1.0,8695,7483,1212
KR_7706393682,120.016,2.0,11560,10940,620
KR_7706393682,180.019,3.0,15068,15460,-392
KR_7706393682,240.041,4.0,18836,18342,494
KR_7706393682,300.143,5.0,22089,21155,934
KR_7706393682,360.149,6.0,25597,24497,1100
KR_7706393682,420.161,7.0,28831,27757,1074
KR_7706393682,480.194,8.0,33706,30668,3038
KR_7706393682,540.2,9.0,36471,34340,2131
KR_7706393682,600.201,10.0,39937,38381,1556
KR_7706393682,660.213,11.0,42489,41664,825
KR_7706393682,720.214,12.0,44652,45390,-738
KR_7706393682,780.218,13.0,48128,48128,0
KR_7706393682,840.237,14.0,51694,51406,288
KR_7706393682,900.27,15.0,55413,54525,888
KR_7706393682,960.302,16.01,57940,57176,764
KR_7706393682,1005.051,16.75,61433,58858,2575
KR_7777272675,0.0,0.0,7000,7000,0
KR_7777272675,60.021,1.0,7015,7015,0
KR_7777272675,120.04,2.0,9952,9526,426
KR_7777272675,180.054,3.0,12772,11942,830
KR_7777272675,240.083,4.0,15925,14759,1166
KR_7777272675,300.138,5.0,19016,17677,1339
KR_7777272675,360.153,6.0,21902,21602,300
KR_7777272675,420.17,7.0,24861,24265,596
KR_7777272675,480.201,8.0,27654,27004,650
KR_7777272675,540.23,9.0,30589,29875,714
KR_7777272675,600.234,10.0,33264,32763,501
KR_7777272675,660.249,11.0,38336,36763,1573
KR_7777272675,720.252,12.0,41919,40307,1612
KR_7777272675,780.265,13.0,44264,43356,908
KR_7777272675,840.283,14.0,47875,46529,1346
KR_7777272675,900.288,15.0,50743,49248,1495
KR_7777272675,960.3,16.0,53771,52311,1460
KR_7777272675,1020.301,17.01,56846,55012,1834
KR_7777272675,1080.319,18.01,59144,58285,859
KR_7777272675,1140.331,19.01,63068,61172,1896
KR_7777272675,1200.338,20.01,66026,63428,2598
KR_7777272675,1260.355,21.01,68446,66299,2147
KR_7777272675,1320.361,22.01,72036,69952,2084
KR_7777272675,1380.392,23.01,75451,73119,2332
KR_7777272675,1440.415,24.01,78168,75506,2662
KR_7777272675,1500.441,25.01,80964,78423,2541
KR_7777272675,1560.462,26.01,84722,81647,3075
KR_7777272675,1620.477,27.01,87167,84953,2214
KR_7777272675,1680.501,28.01,90960,87549,3411
KR_7777272675,1740.518,29.01,96984,90467,6517
KR_7777272675,1800.528,30.01,99137,94592,4545
KR_7777272675,1860.55,31.01,102869,97958,4911
KR_7777272675,1920.568,32.01,105516,101977,3539
KR_7777272675,1980.594,33.01,109026,105509,3517
KR_7777272675,2040.617,34.01,112205,108207,3998
KR_7777272675,2076.404,34.61,115423,109874,5549
KR_7753104042,0.0,0.0,7000,7000,0
KR_7753104042,60.002,1.0,7040,7447,-407
KR_7753104042,120.021,2.0,12288,10601,1687
KR_7753104042,180.025,3.0,15386,13955,1431
KR_7753104042,240.031,4.0,18793,18157,636
KR_7753104042,300.053,5.0,22603,21283,1320
KR_7753104042,360.07,6.0,25664,25001,663
KR_7753104042,420.13,7.0,29629,27903,1726
KR_7753104042,480.152,8.0,33997,31271,2726
KR_7753104042,540.175,9.0,36837,35444,1393
KR_7753104042,600.195,10.0,41833,37705,4128
KR_7753104042,660.226,11.0,44246,41925,2321
KR_7753104042,720.247,12.0,49262,44357,4905
KR_7753104042,780.277,13.0,52437,48804,3633
KR_7753104042,840.301,14.01,54690,54592,98
KR_7753104042,900.331,15.01,59087,57176,1911
KR_7753104042,960.361,16.01,61206,61225,-19
KR_7753104042,984.332,16.41,62478,64130,-1652
KR_7770559951,0.0,0.0,7000,7000,0
KR_7770559951,60.024,1.0,7018,7015,3
KR_7770559951,120.056,2.0,9436,9282,154
KR_7770559951,180.123,3.0,13026,12648,378
KR_7770559951,240.148,4.0,15371,16012,-641
KR_7770559951,300.152,5.0,18326,19909,-1583
KR_7770559951,360.18,6.0,22308,22736,-428
KR_7770559951,420.181,7.0,24974,25659,-685
KR_7770559951,480.214,8.0,27962,28321,-359
KR_7770559951,540.218,9.0,30611,31143,-532
KR_7770559951,600.218,10.0,33925,34920,-995
KR_7770559951,660.248,11.0,36983,38245,-1262
KR_7770559951,720.249,12.0,39268,41274,-2006
KR_7770559951,780.267,13.0,41878,43522,-1644
KR_7770559951,840.289,14.0,44303,45856,-1553
KR_7770559951,900.292,15.0,47874,49049,-1175
KR_7770559951,960.311,16.01,52152,52240,-88
KR_7770559951,1020.335,17.01,54859,55336,-477
KR_7770559951,1080.368,18.01,59827,57254,2573
KR_7770559951,1082.572,18.04,59887,57314,2573
KR_7773524549,0.0,0.0,7000,7000,0
KR_7773524549,60.024,1.0,7015,7015,0
KR_7773524549,120.035,2.0,9365,9394,-29
KR_7773524549,180.056,3.0,12507,12297,210
KR_7773524549,240.075,4.0,16850,16715,135
KR_7773524549,300.129,5.0,19297,20014,-717
KR_7773524549,360.15,6.0,22085,22513,-428
KR_7773524549,420.175,7.0,24769,25739,-970
KR_7773524549,480.199,8.0,28718,28814,-96
KR_7773524549,540.201,9.0,30956,32101,-1145
KR_7773524549,600.223,10.0,33820,35893,-2073
KR_7773524549,660.235,11.0,37347,39066,-1719
KR_7773524549,720.255,12.0,41345,42033,-688
KR_7773524549,780.277,13.0,44149,45284,-1135
KR_7773524549,840.294,14.0,47704,49759,-2055
KR_7773524549,900.3,15.0,49969,52483,-2514
KR_7773524549,960.324,16.01,52887,55194,-2307
KR_7773524549,1020.35,17.01,55786,58160,-2374
KR_7773524549,1080.379,18.01,57869,62663,-4794
KR_7773524549,1140.401,19.01,61954,65148,-3194
KR_7773524549,1200.425,20.01,64865,69882,-5017
KR_7773524549,1260.437,21.01,68590,72553,-3963
KR_7773524549,1320.451,22.01,71193,76391,-5198
KR_7773524549,1380.451,23.01,75808,78465,-2657
KR_7773524549,1430.914,23.85,77512,82482,-4970
KR_7779732848,0.0,0.0,7000,7000,0
KR_7779732848,60.02,1.0,7368,7886,-518
KR_7779732848,120.024,2.0,11207,11051,156
KR_7779732848,180.048,3.0,14096,13902,194
KR_7779732848,240.053,4.0,17664,18062,-398
KR_7779732848,300.155,5.0,20647,20768,-121
KR_7779732848,360.181,6.0,23737,23646,91
KR_7779732848,420.183,7.0,27295,26745,550
KR_7779732848,480.188,8.0,30548,30330,218
KR_7779732848,540.208,9.0,34123,34871,-748
KR_7779732848,600.209,10.0,38463,38333,130
KR_7779732848,660.227,11.0,41108,42432,-1324
KR_7779732848,720.254,12.0,45242,45754,-512
KR_7779732848,780.285,13.0,47350,49589,-2239
KR_7779732848,840.311,14.01,52263,52140,123
KR_7779732848,900.318,15.01,54927,56245,-1318
KR_7779732848,960.331,16.01,59189,59227,-38
KR_7779732848,1020.337,17.01,61573,62339,-766
KR_7779732848,1051.341,17.52,64918,63269,1649
KR_7776725176,0.0,0.0,7000,7000,0
KR_7776725176,60.029,1.0,8282,8528,-246
KR_7776725176,120.059,2.0,11572,11117,455
KR_7776725176,180.133,3.0,14567,15610,-1043
KR_7776725176,240.162,4.0,19037,19461,-424
KR_7776725176,300.177,5.0,22660,23055,-395
KR_7776725176,360.202,6.0,26504,27032,-528
KR_7776725176,420.227,7.0,31034,30229,805
KR_7776725176,480.252,8.0,34492,34064,428
KR_7776725176,540.271,9.0,38564,37252,1312
KR_7776725176,600.283,10.0,41791,41030,761
KR_7776725176,660.288,11.0,45019,44515,504
KR_7776725176,720.317,12.01,49316,47459,1857
KR_7776725176,780.344,13.01,53618,51378,2240
KR_7776725176,840.354,14.01,57168,53641,3527
KR_7776725176,900.374,15.01,60497,57447,3050
KR_7776725176,960.388,16.01,65250,60042,5208
KR_7776725176,995.802,16.6,67255,61503,5752
KR_7768925921,0.0,0.0,7000,7000,0
KR_7768925921,60.005,1.0,7015,7015,0
KR_7768925921,120.01,2.0,9928,10342,-414
KR_7768925921,180.017,3.0,12980,14270,-1290
KR_7768925921,240.038,4.0,16371,17341,-970
KR_7768925921,300.112,5.0,19499,21525,-2026
KR_7768925921,360.143,6.0,23818,25156,-1338
KR_7768925921,420.174,7.0,26147,27472,-1325
KR_7768925921,480.193,8.0,28233,33143,-4910
KR_7768925921,540.215,9.0,32432,36780,-4348
KR_7768925921,600.248,10.0,35510,40484,-4974
KR_7768925921,660.26,11.0,38726,43736,-5010
KR_7768925921,720.275,12.0,41497,48441,-6944
KR_7768925921,729.46,12.16,41767,48761,-6994
KR_7773398771,0.0,0.0,7000,7000,0
KR_7773398771,60.006,1.0,7015,7015,0
KR_7773398771,120.035,2.0,9336,9723,-387
KR_7773398771,180.121,3.0,12238,13119,-881
KR_7773398771,240.144,4.0,14600,15820,-1220
KR_7773398771,300.158,5.0,19180,19077,103
KR_7773398771,360.177,6.0,21500,22188,-688
KR_7773398771,420.203,7.0,24432,26050,-1618
KR_7773398771,480.231,8.0,26924,28690,-1766
KR_7773398771,540.259,9.0,31799,31850,-51
KR_7773398771,600.277,10.0,34449,35974,-1525
KR_7773398771,660.286,11.0,36977,38513,-1536
KR_7773398771,720.313,12.01,40817,41871,-1054
KR_7773398771,780.345,13.01,43219,44485,-1266
KR_7773398771,840.345,14.01,46210,48334,-2124
KR_7773398771,900.371,15.01,48369,51311,-2942
KR_7773398771,960.403,16.01,50880,53793,-2913
KR_7773398771,1020.418,17.01,55284,56573,-1289
KR_7773398771,1080.426,18.01,58044,60391,-2347
KR_7773398771,1140.456,19.01,60267,65769,-5502
KR_7773398771,1200.479,20.01,62377,70042,-7665
KR_7773398771,1219.117,20.32,63116,70977,-7861
KR_7777092443,0.0,0.0,7000,7000,0
KR_7777092443,60.031,1.0,7015,7015,0
KR_7777092443,120.051,2.0,9354,9457,-103
KR_7777092443,180.142,3.0,12129,12337,-208
KR_7777092443,240.162,4.0,15400,14980,420
KR_7777092443,300.183,5.0,17867,17567,300
KR_7777092443,360.188,6.0,21147,21459,-312
KR_7777092443,420.208,7.0,24283,25238,-955
KR_7777092443,480.225,8.0,28413,28621,-208
KR_7777092443,540.253,9.0,31263,31589,-326
KR_7777092443,600.276,10.0,34690,35165,-475
KR_7777092443,660.301,11.01,37401,37503,-102
KR_7777092443,720.317,12.01,40014,41144,-1130
KR_7777092443,780.318,13.01,43914,43905,9
KR_7777092443,840.328,14.01,46674,46518,156
KR_7777092443,900.329,15.01,49141,50684,-1543
KR_7777092443,960.356,16.01,52277,54059,-1782
KR_7777092443,1020.365,17.01,56587,57648,-1061
KR_7777092443,1080.397,18.01,60637,60440,197
KR_7777092443,1140.408,19.01,63163,64176,-1013
KR_7777092443,1200.429,20.01,67779,67436,343
KR_7777092443,1260.442,21.01,70125,70449,-324
KR_7777092443,1320.466,22.01,73242,72907,335
KR_7777092443,1380.476,23.01,76802,77066,-264
KR_7777092443,1440.478,24.01,79377,79871,-494
KR_7777092443,1500.489,25.01,82998,82809,189
KR_7777092443,1560.509,26.01,88484,85361,3123
KR_7777092443,1620.541,27.01,91575,90220,1355
KR_7777092443,1680.543,28.01,93874,93784,90
KR_7777092443,1740.556,29.01,98065,96330,1735
KR_7777092443,1746.568,29.11,98580,96495,2085
KR_7628800435,0.0,0.0,7000,7000,0
KR_7628800435,60.026,1.0,7015,7015,0
KR_7628800435,120.041,2.0,9982,10074,-92
KR_7628800435,180.084,3.0,12783,12459,324
KR_7628800435,240.107,4.0,15646,14869,777
KR_7628800435,300.171,5.0,19947,18431,1516
KR_7628800435,360.201,6.0,23791,22623,1168
KR_7628800435,420.211,7.0,26377,26128,249
KR_7628800435,480.233,8.0,29491,29024,467
KR_7628800435,540.26,9.0,33180,33134,46
KR_7628800435,600.282,10.0,35616,36913,-1297
KR_7628800435,660.3,11.0,39024,39987,-963
KR_7628800435,720.333,12.01,41691,43283,-1592
KR_7628800435,780.341,13.01,46777,45246,1531
KR_7628800435,840.368,14.01,49928,48806,1122
KR_7628800435,900.373,15.01,52608,52378,230
KR_7628800435,960.402,16.01,55343,55048,295
KR_7628800435,1020.425,17.01,57921,58732,-811
KR_7628800435,1080.445,18.01,62125,61740,385
KR_7628800435,1140.471,19.01,64436,65253,-817
KR_7628800435,1200.502,20.01,68037,68883,-846
KR_7628800435,1260.508,21.01,70731,72156,-1425
KR_7628800435,1320.518,22.01,74395,75255,-860
KR_7628800435,1380.546,23.01,77480,78288,-808
KR_7628800435,1440.577,24.01,80201,82018,-1817
KR_7628800435,1500.586,25.01,83367,84474,-1107
KR_7628800435,1560.608,26.01,88891,87276,1615
KR_7628800435,1562.646,26.04,88951,87336,1615
KR_7777859300,0.0,0.0,7000,7000,0
KR_7777859300,60.026,1.0,7015,7447,-432
KR_7777859300,120.054,2.0,9735,10052,-317
KR_7777859300,180.135,3.0,12793,13278,-485
KR_7777859300,240.135,4.0,16492,17093,-601
KR_7777859300,300.168,5.0,20666,20934,-268
KR_7777859300,360.176,6.0,23165,24349,-1184
KR_7777859300,420.183,7.0,26417,27980,-1563
KR_7777859300,480.204,8.0,29567,30406,-839
KR_7777859300,540.226,9.0,32378,33580,-1202
KR_7777859300,600.231,10.0,35988,36452,-464
KR_7777859300,660.264,11.0,39421,39843,-422
KR_7777859300,720.269,12.0,41647,43910,-2263
KR_7777859300,780.299,13.0,46582,47203,-621
KR_7777859300,840.329,14.01,49299,50777,-1478
KR_7777859300,900.338,15.01,52445,54393,-1948
KR_7777859300,960.35,16.01,56048,56803,-755
KR_7777859300,1020.366,17.01,58482,59402,-920
KR_7777859300,1080.378,18.01,60902,64194,-3292
KR_7777859300,1140.409,19.01,64262,67002,-2740
KR_7777859300,1200.412,20.01,68608,70673,-2065
KR_7777859300,1260.414,21.01,71030,73214,-2184
KR_7777859300,1320.445,22.01,74486,76098,-1612
KR_7777859300,1380.454,23.01,78419,79497,-1078
KR_7777859300,1440.482,24.01,82321,82272,49
KR_7777859300,1500.514,25.01,86228,86409,-181
KR_7777859300,1560.533,26.01,89791,89172,619
KR_7777859300,1587.277,26.45,92487,90296,2191
KR_7742322250,0.0,0.0,7000,7000,0
KR_7742322250,60.004,1.0,7015,7015,0
KR_7742322250,120.013,2.0,11564,10570,994
KR_7742322250,180.034,3.0,14868,14578,290
KR_7742322250,240.067,4.0,17944,16853,1091
KR_7742322250,300.154,5.0,21750,21242,508
KR_7742322250,360.173,6.0,25317,23838,1479
KR_7742322250,420.201,7.0,27632,26638,994
KR_7742322250,480.227,8.0,32455,29915,2540
KR_7742322250,540.241,9.0,35677,33212,2465
KR_7742322250,600.255,10.0,39979,36922,3057
KR_7742322250,660.257,11.0,43028,39511,3517
KR_7742322250,720.275,12.0,45316,43159,2157
KR_7742322250,780.287,13.0,50305,45572,4733
KR_7742322250,840.297,14.0,52270,50717,1553
KR_7742322250,900.32,15.01,57517,53073,4444
KR_7742322250,960.337,16.01,60437,56142,4295
KR_7742322250,1020.339,17.01,64438,58399,6039
KR_7742322250,1035.269,17.25,65104,58849,6255
KR_7644332533,0.0,0.0,7000,7000,0
KR_7644332533,60.025,1.0,8437,7290,1147
KR_7644332533,120.042,2.0,11616,10000,1616
KR_7644332533,180.058,3.0,15750,13336,2414
KR_7644332533,240.078,4.0,19144,16918,2226
KR_7644332533,300.125,5.0,22293,20625,1668
KR_7644332533,360.141,6.0,25378,23407,1971
KR_7644332533,420.181,7.0,28632,26174,2458
KR_7644332533,480.197,8.0,32360,28955,3405
KR_7644332533,540.223,9.0,36494,32278,4216
KR_7644332533,600.238,10.0,39718,34807,4911
KR_7644332533,660.264,11.0,42390,38646,3744
KR_7644332533,720.29,12.0,46365,41547,4818
KR_7644332533,780.307,13.01,49814,44759,5055
KR_7644332533,840.325,14.01,52836,47730,5106
KR_7644332533,900.34,15.01,55918,51001,4917
KR_7644332533,960.354,16.01,58572,53792,4780
KR_7644332533,1020.38,17.01,61665,56670,4995
KR_7644332533,1080.408,18.01,65461,59536,5925
KR_7644332533,1140.427,19.01,70270,62401,7869
KR_7644332533,1148.709,19.15,70510,62911,7599
KR_7772014120,0.0,0.0,7000,7000,0
KR_7772014120,60.02,1.0,7015,7400,-385
KR_7772014120,120.043,2.0,9394,11482,-2088
KR_7772014120,180.123,3.0,13765,14747,-982
KR_7772014120,240.123,4.0,16946,18154,-1208
KR_7772014120,300.139,5.0,19431,21207,-1776
KR_7772014120,360.145,6.0,22431,24743,-2312
KR_7772014120,420.169,7.0,25827,28033,-2206
KR_7772014120,480.174,8.0,29639,30618,-979
KR_7772014120,540.18,9.0,32625,34906,-2281
KR_7772014120,600.181,10.0,37480,37644,-164
KR_7772014120,660.214,11.0,40706,41052,-346
KR_7772014120,720.226,12.0,44496,44644,-148
KR_7772014120,780.238,13.0,47703,47701,2
KR_7772014120,840.269,14.0,50537,50804,-267
KR_7772014120,900.269,15.0,53244,54920,-1676
KR_7772014120,960.274,16.0,56785,57746,-961
KR_7772014120,1020.292,17.0,58874,61980,-3106
KR_7772014120,1080.31,18.01,63220,66101,-2881
KR_7772014120,1140.312,19.01,66571,70432,-3861
KR_7772014120,1179.127,19.65,68182,72732,-4550
KR_7779604954,0.0,0.0,7000,7000,0
KR_7779604954,60.031,1.0,7785,7015,770
KR_7779604954,120.054,2.0,10453,9289,1164
KR_7779604954,180.056,3.0,12649,13986,-1337
KR_7779604954,240.075,4.0,16498,17040,-542
KR_7779604954,300.076,5.0,19922,20516,-594
KR_7779604954,360.106,6.0,22749,24423,-1674
KR_7779604954,420.183,7.0,26798,27612,-814
KR_7779604954,480.207,8.0,29387,30856,-1469
KR_7779604954,540.22,9.0,34283,34759,-476
KR_7779604954,600.241,10.0,36790,38775,-1985
KR_7779604954,660.243,11.0,40584,42104,-1520
KR_7779604954,720.272,12.0,43719,45945,-2226
KR_7779604954,780.302,13.01,47278,50024,-2746
KR_7779604954,840.329,14.01,49689,54022,-4333
KR_7779604954,900.355,15.01,52026,56501,-4475
KR_7779604954,960.367,16.01,57389,58483,-1094
KR_7779604954,1020.399,17.01,59633,64227,-4594
KR_7779604954,1031.35,17.19,60668,64607,-3939
KR_7750305443,0.0,0.0,7000,7000,0
KR_7750305443,60.019,1.0,7275,8150,-875
KR_7750305443,120.024,2.0,10524,11412,-888
KR_7750305443,180.049,3.0,13087,14046,-959
KR_7750305443,240.077,4.0,15981,16807,-826
KR_7750305443,300.079,5.0,19784,20155,-371
KR_7750305443,360.107,6.0,22819,23542,-723
KR_7750305443,420.111,7.0,25664,27768,-2104
KR_7750305443,480.117,8.0,29048,30636,-1588
KR_7750305443,540.139,9.0,32930,35620,-2690
KR_7750305443,600.157,10.0,35542,38651,-3109
KR_7750305443,660.248,11.0,38428,43409,-4981
KR_7750305443,720.278,12.0,41726,46385,-4659
KR_7750305443,780.282,13.0,44129,50603,-6474
KR_7750305443,818.239,13.64,45715,53583,-7868
KR_7625549675,0.0,0.0,7000,7000,0
KR_7625549675,60.024,1.0,7015,7015,0
KR_7625549675,120.044,2.0,9330,9297,33
KR_7625549675,180.117,3.0,11741,11806,-65
KR_7625549675,240.138,4.0,14547,15401,-854
KR_7625549675,300.156,5.0,17391,18484,-1093
KR_7625549675,360.189,6.0,20633,22236,-1603
KR_7625549675,420.195,7.0,24297,24765,-468
KR_7625549675,480.215,8.0,27146,27699,-553
KR_7625549675,540.216,9.0,30136,30433,-297
KR_7625549675,600.226,10.0,33187,33371,-184
KR_7625549675,660.237,11.0,36583,38294,-1711
KR_7625549675,720.257,12.0,38891,40715,-1824
KR_7625549675,780.279,13.0,42463,43304,-841
KR_7625549675,840.279,14.0,46515,46015,500
KR_7625549675,900.293,15.0,49591,48298,1293
KR_7625549675,960.324,16.01,52733,52172,561
KR_7625549675,1020.336,17.01,55521,54301,1220
KR_7625549675,1044.505,17.41,57370,55378,1992
KR_7771395586,0.0,0.0,7000,7000,0
KR_7771395586,60.031,1.0,7437,7015,422
KR_7771395586,120.056,2.0,10668,9533,1135
KR_7771395586,180.057,3.0,13640,13017,623
KR_7771395586,240.09,4.0,16272,17115,-843
KR_7771395586,300.158,5.0,20283,20682,-399
KR_7771395586,360.19,6.0,24180,23662,518
KR_7771395586,420.206,7.0,27353,26689,664
KR_7771395586,480.216,8.0,31830,29616,2214
KR_7771395586,540.233,9.0,34413,32754,1659
KR_7771395586,600.242,10.0,38273,36267,2006
KR_7771395586,660.261,11.0,41878,39571,2307
KR_7771395586,720.273,12.0,45397,41798,3599
KR_7771395586,780.284,13.0,48403,45765,2638
KR_7771395586,840.31,14.01,51907,48574,3333
KR_7771395586,900.328,15.01,54646,53573,1073
KR_7771395586,960.34,16.01,58345,56238,2107
KR_7771395586,1020.36,17.01,60326,59976,350
KR_7771395586,1080.364,18.01,63114,62944,170
KR_7771395586,1140.368,19.01,67278,65919,1359
KR_7771395586,1173.803,19.56,70480,66924,3556
KR_7740283492,0.0,0.0,7000,7000,0
KR_7740283492,60.019,1.0,7015,7015,0
KR_7740283492,120.03,2.0,9646,10620,-974
KR_7740283492,180.05,3.0,12719,13549,-830
KR_7740283492,240.054,4.0,16243,17755,-1512
KR_7740283492,300.081,5.0,18982,21528,-2546
KR_7740283492,360.101,6.0,23819,24555,-736
KR_7740283492,420.181,7.0,27146,28230,-1084
KR_7740283492,480.207,8.0,30445,31887,-1442
KR_7740283492,540.218,9.0,33276,34103,-827
KR_7740283492,600.243,10.0,36566,37259,-693
KR_7740283492,660.265,11.0,39219,40519,-1300
KR_7740283492,720.291,12.0,42019,43525,-1506
KR_7740283492,780.305,13.01,46823,47740,-917
KR_7740283492,840.325,14.01,49831,50877,-1046
KR_7740283492,900.343,15.01,52931,53952,-1021
KR_7740283492,960.363,16.01,55746,56475,-729
KR_7740283492,1020.368,17.01,58019,60203,-2184
KR_7740283492,1080.389,18.01,62084,63293,-1209
KR_7740283492,1140.412,19.01,65798,65869,-71
KR_7740283492,1200.445,20.01,70085,69414,671
KR_7740283492,1260.462,21.01,73011,72391,620
KR_7740283492,1319.981,22.0,77614,74835,2779
KR_7769847337,0.0,0.0,7000,7000,0
KR_7769847337,60.027,1.0,7392,7428,-36
KR_7769847337,120.036,2.0,10110,11251,-1141
KR_7769847337,180.136,3.0,12568,14020,-1452
KR_7769847337,240.143,4.0,14988,17171,-2183
KR_7769847337,300.158,5.0,19239,20585,-1346
KR_7769847337,360.187,6.0,22387,24012,-1625
KR_7769847337,420.214,7.0,25057,27131,-2074
KR_7769847337,480.242,8.0,28683,31162,-2479
KR_7769847337,540.264,9.0,30996,34030,-3034
KR_7769847337,600.276,10.0,34315,37543,-3228
KR_7769847337,660.284,11.0,36813,41436,-4623
KR_7769847337,720.291,12.0,40500,46061,-5561
KR_7769847337,780.324,13.01,42930,49720,-6790
KR_7769847337,808.267,13.47,43770,52659,-8889
KR_7633084629,0.0,0.0,7000,7000,0
KR_7633084629,60.026,1.0,7489,7344,145
KR_7633084629,120.049,2.0,10564,9936,628
KR_7633084629,180.115,3.0,13979,13989,-10
KR_7633084629,240.145,4.0,18492,16904,1588
KR_7633084629,300.162,5.0,20945,20182,763
KR_7633084629,360.185,6.0,23360,22533,827
KR_7633084629,420.198,7.0,26311,25120,1191
KR_7633084629,480.228,8.0,29265,30071,-806
KR_7633084629,540.243,9.0,32095,32555,-460
KR_7633084629,600.268,10.0,34726,36281,-1555
KR_7633084629,660.271,11.0,37665,38590,-925
KR_7633084629,720.273,12.0,41946,41474,472
KR_7633084629,780.277,13.0,44430,44017,413
KR_7633084629,840.303,14.01,48141,47526,615
KR_7633084629,900.323,15.01,50412,50233,179
KR_7633084629,960.339,16.01,53075,52542,533
KR_7633084629,1020.341,17.01,57711,56158,1553
KR_7633084629,1080.35,18.01,60236,58563,1673
KR_7633084629,1140.362,19.01,63952,64940,-988
KR_7633084629,1200.389,20.01,67899,67424,475
KR_7633084629,1260.395,21.01,71261,70775,486
KR_7633084629,1320.41,22.01,75236,74284,952
KR_7633084629,1380.42,23.01,77416,77075,341
KR_7633084629,1440.432,24.01,81769,79552,2217
KR_7633084629,1447.78,24.13,82779,79762,3017
KR_7773618030,0.0,0.0,7000,7000,0
KR_7773618030,60.022,1.0,7015,7015,0
KR_7773618030,120.048,2.0,9716,9692,24
KR_7773618030,180.14,3.0,13910,13129,781
KR_7773618030,240.168,4.0,17590,15766,1824
KR_7773618030,300.185,5.0,20272,18825,1447
KR_7773618030,360.192,6.0,24117,22112,2005
KR_7773618030,420.207,7.0,27053,25246,1807
KR_7773618030,480.208,8.0,31777,29545,2232
KR_7773618030,522.147,8.7,34210,30991,3219
KR_7778095911,0.0,0.0,7000,7000,0
KR_7778095911,60.017,1.0,7427,7015,412
KR_7778095911,120.033,2.0,9813,9270,543
KR_7778095911,180.103,3.0,13294,11785,1509
KR_7778095911,240.122,4.0,16256,16499,-243
KR_7778095911,300.139,5.0,20010,20425,-415
KR_7778095911,360.156,6.0,22477,22839,-362
KR_7778095911,420.164,7.0,26660,26645,15
KR_7778095911,480.193,8.0,29121,30762,-1641
KR_7778095911,540.218,9.0,32274,35458,-3184
KR_7778095911,600.252,10.0,36294,38601,-2307
KR_7778095911,660.26,11.0,38725,42605,-3880
KR_7778095911,688.55,11.48,40453,44838,-4385
KR_7673853453,0.0,0.0,7000,7000,0
KR_7673853453,60.03,1.0,7025,7661,-636
KR_7673853453,120.058,2.0,10677,11678,-1001
KR_7673853453,180.138,3.0,13120,14851,-1731
KR_7673853453,240.159,4.0,17944,18135,-191
KR_7673853453,300.185,5.0,21098,21833,-735
KR_7673853453,360.202,6.0,25873,24737,1136
KR_7673853453,420.218,7.0,29738,29492,246
KR_7673853453,480.243,8.0,32847,33498,-651
KR_7673853453,540.257,9.0,35748,35785,-37
KR_7673853453,600.279,10.0,39649,38773,876
KR_7673853453,660.288,11.0,42256,41816,440
KR_7673853453,720.31,12.01,45443,46123,-680
KR_7673853453,780.333,13.01,48474,48719,-245
KR_7673853453,840.335,14.01,53250,50979,2271
KR_7673853453,900.36,15.01,56432,55250,1182
KR_7673853453,960.383,16.01,59115,58608,507
KR_7673853453,1020.401,17.01,62471,61889,582
KR_7673853453,1080.407,18.01,66027,65061,966
KR_7673853453,1140.411,19.01,69359,68077,1282
KR_7673853453,1200.419,20.01,71905,70580,1325
KR_7673853453,1219.966,20.33,74590,71241,3349
KR_7628845700,0.0,0.0,7000,7000,0
KR_7628845700,60.022,1.0,7015,7015,0
KR_7628845700,120.027,2.0,10986,10654,332
KR_7628845700,180.05,3.0,15261,14794,467
KR_7628845700,240.082,4.0,18062,17125,937
KR_7628845700,300.17,5.0,21885,20890,995
KR_7628845700,360.195,6.0,26714,24348,2366
KR_7628845700,420.208,7.0,29429,27052,2377
KR_7628845700,480.24,8.0,32026,30548,1478
KR_7628845700,540.264,9.0,35489,33027,2462
KR_7628845700,600.265,10.0,37858,37734,124
KR_7628845700,660.292,11.0,41910,40786,1124
KR_7628845700,720.315,12.01,45911,43989,1922
KR_7628845700,780.336,13.01,49536,47327,2209
KR_7628845700,840.362,14.01,52737,49377,3360
KR_7628845700,900.39,15.01,56872,53102,3770
KR_7628845700,960.418,16.01,59853,55984,3869
KR_7628845700,1020.432,17.01,62344,59872,2472
KR_7628845700,1080.444,18.01,66238,63096,3142
KR_7628845700,1140.445,19.01,70748,65651,5097
KR_7628845700,1141.781,19.03,70793,65696,5097
KR_7751252538,0.0,0.0,7000,7000,0
KR_7751252538,60.019,1.0,7015,7015,0
KR_7751252538,120.047,2.0,9331,9433,-102
KR_7751252538,180.088,3.0,11911,11912,-1
KR_7751252538,240.102,4.0,14238,14326,-88
KR_7751252538,300.159,5.0,17445,17165,280
KR_7751252538,360.175,6.0,20174,19889,285
KR_7751252538,420.197,7.0,23506,22847,659
KR_7751252538,480.213,8.0,26177,26135,42
KR_7751252538,540.228,9.0,29609,28986,623
KR_7751252538,600.244,10.0,32905,32284,621
KR_7751252538,660.264,11.0,36254,35366,888
KR_7751252538,720.287,12.0,38413,40343,-1930
KR_7751252538,780.304,13.01,43728,42666,1062
KR_7751252538,840.332,14.01,46866,45936,930
KR_7751252538,900.337,15.01,49458,48813,645
KR_7751252538,960.354,16.01,52427,51827,600
KR_7751252538,1020.366,17.01,55356,54576,780
KR_7751252538,1080.382,18.01,60096,58287,1809
KR_7751252538,1140.394,19.01,62194,61329,865
KR_7751252538,1200.397,20.01,66096,64679,1417
KR_7751252538,1260.407,21.01,68765,66883,1882
KR_7751252538,1320.434,22.01,71086,69537,1549
KR_7751252538,1380.449,23.01,74864,72140,2724
KR_7751252538,1384.323,23.07,74984,72260,2724
KR_7777046526,0.0,0.0,7000,7000,0
KR_7777046526,60.032,1.0,7015,7015,0
KR_7777046526,120.054,2.0,9994,10910,-916
KR_7777046526,180.141,3.0,13268,13265,3
KR_7777046526,240.166,4.0,16570,16278,292
KR_7777046526,300.182,5.0,20679,20357,322
KR_7777046526,360.193,6.0,24690,24172,518
KR_7777046526,420.203,7.0,28380,27451,929
KR_7777046526,480.228,8.0,32204,31684,520
KR_7777046526,540.241,9.0,35061,34095,966
KR_7777046526,600.256,10.0,38363,37619,744
KR_7777046526,660.265,11.0,41616,40748,868
KR_7777046526,720.291,12.0,44464,45457,-993
KR_7777046526,780.297,13.0,48175,48902,-727
KR_7777046526,840.328,14.01,51013,52110,-1097
KR_7777046526,900.346,15.01,54614,55923,-1309
KR_7777046526,960.351,16.01,58938,58885,53
KR_7777046526,1020.354,17.01,61722,61836,-114
KR_7777046526,1080.357,18.01,64414,65387,-973
KR_7777046526,1140.361,19.01,68735,68548,187
KR_7777046526,1200.372,20.01,71560,71371,189
KR_7777046526,1260.379,21.01,75646,74447,1199
KR_7777046526,1320.382,22.01,78289,76759,1530
KR_7777046526,1380.389,23.01,80395,82492,-2097
KR_7777046526,1389.85,23.16,81296,83127,-1831
KR_7769819084,0.0,0.0,7000,7000,0
KR_7769819084,60.033,1.0,7015,7015,0
KR_7769819084,120.055,2.0,10180,10992,-812
KR_7769819084,180.059,3.0,15459,15218,241
KR_7769819084,240.086,4.0,19583,19982,-399
KR_7769819084,300.172,5.0,22033,23128,-1095
KR_7769819084,360.196,6.0,26066,26697,-631
KR_7769819084,420.218,7.0,30068,30412,-344
KR_7769819084,480.245,8.0,33360,33753,-393
KR_7769819084,540.258,9.0,36616,37504,-888
KR_7769819084,600.279,10.0,40683,40470,213
KR_7769819084,660.296,11.0,43750,44478,-728
KR_7769819084,720.311,12.01,47938,47201,737
KR_7769819084,780.323,13.01,51981,49911,2070
KR_7769819084,840.342,14.01,55603,53337,2266
KR_7769819084,900.342,15.01,57886,58004,-118
KR_7769819084,960.36,16.01,61731,60412,1319
KR_7769819084,1020.361,17.01,64407,65184,-777
KR_7769819084,1038.465,17.31,65310,66805,-1495
KR_7767534094,0.0,0.0,7000,7000,0
KR_7767534094,60.026,1.0,7313,7493,-180
KR_7767534094,120.059,2.0,10171,10336,-165
KR_7767534094,180.129,3.0,14190,13326,864
KR_7767534094,240.15,4.0,17391,17040,351
KR_7767534094,300.156,5.0,21362,20280,1082
KR_7767534094,360.18,6.0,24471,24725,-254
KR_7767534094,420.201,7.0,27890,27404,486
KR_7767534094,480.216,8.0,30807,32615,-1808
KR_7767534094,510.311,8.51,32401,34863,-2462
KR_7751499662,0.0,0.0,7000,7000,0
KR_7751499662,60.031,1.0,7437,7015,422
KR_7751499662,120.035,2.0,10564,10278,286
KR_7751499662,180.063,3.0,13186,13008,178
KR_7751499662,240.079,4.0,16514,16582,-68
KR_7751499662,300.14,5.0,19740,18944,796
KR_7751499662,360.17,6.0,23143,22010,1133
KR_7751499662,420.176,7.0,26385,25190,1195
KR_7751499662,480.182,8.0,29926,28376,1550
KR_7751499662,540.205,9.0,32742,31350,1392
KR_7751499662,600.212,10.0,35256,34809,447
KR_7751499662,660.214,11.0,37823,38505,-682
KR_7751499662,720.23,12.0,42745,42380,365
KR_7751499662,780.239,13.0,46358,44844,1514
KR_7751499662,840.255,14.0,49367,48762,605
KR_7751499662,900.259,15.0,52320,50800,1520
KR_7751499662,960.261,16.0,55995,53045,2950
KR_7751499662,1020.271,17.0,59389,57529,1860
KR_7751499662,1074.213,17.9,63152,59153,3999
KR_7775329871,0.0,0.0,7000,7000,0
KR_7775329871,60.011,1.0,7015,7487,-472
KR_7775329871,120.041,2.0,9298,9802,-504
KR_7775329871,180.041,3.0,12925,13626,-701
KR_7775329871,240.052,4.0,15846,17270,-1424
KR_7775329871,300.137,5.0,20583,20568,15
KR_7775329871,360.163,6.0,23017,22971,46
KR_7775329871,420.167,7.0,26032,26284,-252
KR_7775329871,480.194,8.0,28963,29079,-116
KR_7775329871,540.204,9.0,32317,32438,-121
KR_7775329871,600.236,10.0,35424,35429,-5
KR_7775329871,660.261,11.0,38466,39228,-762
KR_7775329871,720.263,12.0,42075,41929,146
KR_7775329871,780.276,13.0,46192,45315,877
KR_7775329871,840.303,14.01,49392,47864,1528
KR_7775329871,900.319,15.01,53117,50796,2321
KR_7775329871,960.328,16.01,56367,54366,2001
KR_7775329871,1020.337,17.01,58488,59346,-858
KR_7775329871,1080.361,18.01,61547,62517,-970
KR_7775329871,1140.374,19.01,64763,66182,-1419
KR_7775329871,1200.381,20.01,67458,68524,-1066
KR_7775329871,1260.395,21.01,69574,72307,-2733
KR_7775329871,1320.426,22.01,72692,75218,-2526
KR_7775329871,1380.456,23.01,76576,78675,-2099
KR_7775329871,1440.481,24.01,79839,81816,-1977
KR_7775329871,1500.486,25.01,84860,84390,470
KR_7775329871,1519.259,25.32,86583,85135,1448
KR_7773261960,0.0,0.0,7000,7000,0
KR_7773261960,60.004,1.0,7015,7015,0
KR_7773261960,120.034,2.0,9365,9210,155
KR_7773261960,180.131,3.0,12011,12440,-429
KR_7773261960,240.156,4.0,15539,15435,104
KR_7773261960,300.175,5.0,18745,17902,843
KR_7773261960,360.204,6.0,21088,20819,269
KR_7773261960,420.219,7.0,23651,23921,-270
KR_7773261960,480.25,8.0,27959,27355,604
KR_7773261960,540.277,9.0,30787,30166,621
KR_7773261960,600.309,10.01,34081,34276,-195
KR_7773261960,660.321,11.01,37106,36485,621
KR_7773261960,720.346,12.01,39767,38809,958
KR_7773261960,780.369,13.01,42830,41215,1615
KR_7773261960,826.64,13.78,45901,43258,2643
KR_7765771165,0.0,0.0,7000,7000,0
KR_7765771165,60.004,1.0,7015,7015,0
KR_7765771165,120.009,2.0,9940,9566,374
KR_7765771165,180.032,3.0,13068,13487,-419
KR_7765771165,240.063,4.0,16775,16430,345
KR_7765771165,300.148,5.0,19543,21066,-1523
KR_7765771165,360.171,6.0,22875,23882,-1007
KR_7765771165,420.188,7.0,26937,27074,-137
KR_7765771165,480.209,8.0,29506,32095,-2589
KR_7765771165,540.229,9.0,33088,34657,-1569
KR_7765771165,600.252,10.0,36537,37993,-1456
KR_7765771165,660.269,11.0,40629,40416,213
KR_7765771165,720.291,12.0,44664,44536,128
KR_7765771165,780.299,13.0,47969,47663,306
KR_7765771165,840.312,14.01,50886,52677,-1791
KR_7765771165,900.321,15.01,55257,54763,494
KR_7765771165,960.328,16.01,57774,58945,-1171
KR_7765771165,1020.356,17.01,61455,61928,-473
KR_7765771165,1080.386,18.01,63546,66456,-2910
KR_7765771165,1093.78,18.23,63951,68411,-4460
KR_7737941457,0.0,0.0,7000,7000,0
KR_7737941457,60.031,1.0,7373,7447,-74
KR_7737941457,120.044,2.0,11635,11596,39
KR_7737941457,180.045,3.0,14970,14830,140
KR_7737941457,240.077,4.0,19294,18710,584
KR_7737941457,300.163,5.0,23332,21051,2281
KR_7737941457,360.176,6.0,26940,25134,1806
KR_7737941457,420.212,7.0,30873,28539,2334
KR_7737941457,480.233,8.0,33540,32387,1153
KR_7737941457,540.264,9.0,37383,37068,315
KR_7737941457,600.282,10.0,40850,39398,1452
KR_7737941457,660.295,11.0,44494,43487,1007
KR_7737941457,720.3,12.0,48064,46362,1702
KR_7737941457,780.328,13.01,51576,49723,1853
KR_7737941457,840.358,14.01,56240,52441,3799
KR_7737941457,900.369,15.01,58629,57793,836
KR_7737941457,927.458,15.46,60597,58603,1994
KR_7769890564,0.0,0.0,7000,7000,0
KR_7769890564,60.014,1.0,7015,7015,0
KR_7769890564,120.016,2.0,11113,10978,135
KR_7769890564,180.044,3.0,14791,14136,655
KR_7769890564,240.044,4.0,17264,18034,-770
KR_7769890564,300.059,5.0,22742,21156,1586
KR_7769890564,360.079,6.0,25684,24773,911
KR_7769890564,420.183,7.0,28708,27403,1305
KR_7769890564,480.199,8.0,32739,31135,1604
KR_7769890564,540.231,9.0,35493,35249,244
KR_7769890564,600.264,10.0,39252,38845,407
KR_7769890564,660.278,11.0,41455,42122,-667
KR_7769890564,720.306,12.01,45364,44501,863
KR_7769890564,780.338,13.01,50835,47244,3591
KR_7769890564,840.356,14.01,54179,50862,3317
KR_7769890564,900.381,15.01,57576,54648,2928
KR_7769890564,960.39,16.01,60805,56918,3887
KR_7769890564,1020.401,17.01,63725,59410,4315
KR_7769890564,1046.975,17.45,66439,60205,6234
KR_7753060439,0.0,0.0,7000,7000,0
KR_7753060439,60.012,1.0,7015,7015,0
KR_7753060439,120.036,2.0,10854,11055,-201
KR_7753060439,180.133,3.0,14704,14424,280
KR_7753060439,240.154,4.0,17923,18561,-638
KR_7753060439,300.174,5.0,21420,22201,-781
KR_7753060439,360.195,6.0,24853,24805,48
KR_7753060439,420.207,7.0,28033,29030,-997
KR_7753060439,480.232,8.0,32999,31811,1188
KR_7753060439,540.265,9.0,36037,35089,948
KR_7753060439,600.291,10.0,39956,38438,1518
KR_7753060439,660.307,11.01,42125,42439,-314
KR_7753060439,720.307,12.01,45498,46774,-1276
KR_7753060439,780.314,13.01,48804,49548,-744
KR_7753060439,840.346,14.01,51894,53596,-1702
KR_7753060439,900.37,15.01,55425,55986,-561
KR_7753060439,960.38,16.01,58677,59468,-791
KR_7753060439,1020.382,17.01,60868,64992,-4124
KR_7753060439,1028.666,17.14,61543,65326,-3783
KR_7778592363,0.0,0.0,7000,7000,0
KR_7778592363,60.013,1.0,7015,7027,-12
KR_7778592363,120.028,2.0,9442,9365,77
KR_7778592363,180.045,3.0,13380,13817,-437
KR_7778592363,240.056,4.0,16302,16321,-19
KR_7778592363,300.168,5.0,19467,18939,528
KR_7778592363,360.182,6.0,22953,23597,-644
KR_7778592363,420.201,7.0,26083,27743,-1660
KR_7778592363,480.219,8.0,28972,31402,-2430
KR_7778592363,540.221,9.0,32463,34980,-2517
KR_7778592363,600.254,10.0,35290,38565,-3275
KR_7778592363,660.269,11.0,40761,42156,-1395
KR_7778592363,720.276,12.0,43968,45308,-1340
KR_7778592363,780.288,13.0,46701,47973,-1272
KR_7778592363,840.289,14.0,50809,51450,-641
KR_7778592363,900.291,15.0,53985,55553,-1568
KR_7778592363,960.302,16.01,57569,58469,-900
KR_7778592363,1020.336,17.01,60453,61326,-873
KR_7778592363,1080.362,18.01,63082,66430,-3348
KR_7778592363,1100.709,18.35,63697,67819,-4122
KR_7724030521,0.0,0.0,7000,7000,0
KR_7724030521,60.015,1.0,7015,7015,0
KR_7724030521,120.038,2.0,10090,9953,137
KR_7724030521,180.104,3.0,13149,12502,647
KR_7724030521,240.106,4.0,16718,15981,737
KR_7724030521,300.119,5.0,20118,19138,980
KR_7724030521,360.146,6.0,22354,22543,-189
KR_7724030521,420.151,7.0,27101,25384,1717
KR_7724030521,480.184,8.0,29319,28128,1191
KR_7724030521,540.187,9.0,33172,32211,961
KR_7724030521,600.211,10.0,36320,35597,723
KR_7724030521,660.242,11.0,40356,38372,1984
KR_7724030521,720.26,12.0,43059,43224,-165
KR_7724030521,780.288,13.0,46923,45442,1481
KR_7724030521,840.29,14.0,50312,49429,883
KR_7724030521,900.307,15.01,54440,51838,2602
KR_7724030521,960.337,16.01,57157,55435,1722
KR_7724030521,1020.339,17.01,60774,58380,2394
KR_7724030521,1080.354,18.01,63148,61689,1459
KR_7724030521,1140.386,19.01,66418,63974,2444
KR_7724030521,1200.396,20.01,69054,67389,1665
KR_7724030521,1260.414,21.01,73965,69414,4551
KR_7724030521,1320.443,22.01,76849,73659,3190
KR_7724030521,1380.443,23.01,79662,76134,3528
KR_7724030521,1440.467,24.01,82022,79782,2240
KR_7724030521,1500.499,25.01,84834,83481,1353
KR_7724030521,1560.513,26.01,88101,88403,-302
KR_7724030521,1561.815,26.03,88131,88433,-302
KR_7747299571,0.0,0.0,7000,7000,0
KR_7747299571,60.015,1.0,7015,7015,0
KR_7747299571,120.016,2.0,9661,9925,-264
KR_7747299571,180.046,3.0,12590,12573,17
KR_7747299571,240.065,4.0,16517,16886,-369
KR_7747299571,300.151,5.0,20207,20287,-80
KR_7747299571,360.174,6.0,23961,24175,-214
KR_7747299571,420.186,7.0,26753,27302,-549
KR_7747299571,480.208,8.0,30444,30795,-351
KR_7747299571,540.233,9.0,33219,33565,-346
KR_7747299571,600.253,10.0,36179,37889,-1710
KR_7747299571,660.267,11.0,39539,40982,-1443
KR_7747299571,720.287,12.0,43681,44885,-1204
KR_7747299571,780.29,13.0,47066,47431,-365
KR_7747299571,840.295,14.0,50926,49842,1084
KR_7747299571,900.3,15.0,54170,54601,-431
KR_7747299571,960.33,16.01,57798,57610,188
KR_7747299571,1020.347,17.01,60664,61110,-446
KR_7747299571,1080.369,18.01,64206,64067,139
KR_7747299571,1140.394,19.01,67491,67652,-161
KR_7747299571,1178.749,19.65,71496,68807,2689
KR_7765807736,0.0,0.0,7000,7000,0
KR_7765807736,60.009,1.0,7263,7447,-184
KR_7765807736,120.032,2.0,10469,10987,-518
KR_7765807736,180.035,3.0,13608,14475,-867
KR_7765807736,240.037,4.0,16540,17501,-961
KR_7765807736,300.043,5.0,20627,21115,-488
KR_7765807736,360.065,6.0,23533,23732,-199
KR_7765807736,420.068,7.0,27225,27140,85
KR_7765807736,480.101,8.0,29580,30258,-678
KR_7765807736,540.159,9.0,33619,33368,251
KR_7765807736,600.174,10.0,35738,38566,-2828
KR_7765807736,660.189,11.0,39880,41408,-1528
KR_7765807736,720.19,12.0,43062,44345,-1283
KR_7765807736,780.2,13.0,46701,47486,-785
KR_7765807736,840.207,14.0,50342,50154,188
KR_7765807736,900.214,15.0,53507,52919,588
KR_7765807736,960.231,16.0,56775,56623,152
KR_7765807736,1020.254,17.0,59476,58876,600
KR_7765807736,1080.269,18.0,62821,62325,496
KR_7765807736,1140.273,19.0,65009,66371,-1362
KR_7765807736,1200.279,20.0,68463,69549,-1086
KR_7765807736,1260.307,21.01,71653,72171,-518
KR_7765807736,1320.311,22.01,75289,75783,-494
KR_7765807736,1380.325,23.01,78338,79030,-692
KR_7765807736,1440.347,24.01,80857,81815,-958
KR_7765807736,1500.354,25.01,84125,84975,-850
KR_7765807736,1560.383,26.01,86343,88801,-2458
KR_7765807736,1620.384,27.01,89941,91617,-1676
KR_7765807736,1651.414,27.52,93726,92559,1167
KR_7767655828,0.0,0.0,7000,7000,0
KR_7767655828,60.014,1.0,7015,7015,0
KR_7767655828,120.039,2.0,10101,10575,-474
KR_7767655828,180.14,3.0,13950,14283,-333
KR_7767655828,240.161,4.0,18607,18467,140
KR_7767655828,300.19,5.0,21874,22181,-307
KR_7767655828,360.212,6.0,24542,25463,-921
KR_7767655828,420.239,7.0,29568,29380,188
KR_7767655828,480.261,8.0,32161,33035,-874
KR_7767655828,540.281,9.0,35168,36615,-1447
KR_7767655828,576.921,9.62,37389,39209,-1820
KR_7767038022,0.0,0.0,7000,7000,0
KR_7767038022,60.027,1.0,7377,7015,362
KR_7767038022,120.038,2.0,10267,9377,890
KR_7767038022,180.13,3.0,13148,12284,864
KR_7767038022,240.156,4.0,15942,15517,425
KR_7767038022,300.179,5.0,20077,19035,1042
KR_7767038022,360.21,6.0,23080,22992,88
KR_7767038022,420.212,7.0,25937,25685,252
KR_7767038022,480.244,8.0,29811,28220,1591
KR_7767038022,540.245,9.0,33362,31390,1972
KR_7767038022,600.258,10.0,36558,34634,1924
KR_7767038022,660.275,11.0,39570,38026,1544
KR_7767038022,720.304,12.01,43142,40418,2724
KR_7767038022,780.311,13.01,47373,42569,4804
KR_7767038022,840.329,14.01,50123,47052,3071
KR_7767038022,900.333,15.01,53972,50465,3507
KR_7767038022,960.348,16.01,56297,54354,1943
KR_7767038022,1020.375,17.01,60048,57518,2530
KR_7767038022,1080.4,18.01,62517,61006,1511
KR_7767038022,1140.425,19.01,65945,64213,1732
KR_7767038022,1200.435,20.01,70114,67422,2692
KR_7767038022,1260.455,21.01,73352,70366,2986
KR_7767038022,1320.484,22.01,76211,74304,1907
KR_7767038022,1380.505,23.01,79150,77924,1226
KR_7767038022,1440.533,24.01,81674,83448,-1774
KR_7767038022,1500.563,25.01,85751,86247,-496
KR_7767038022,1560.586,26.01,89015,89357,-342
KR_7767038022,1613.777,26.9,90663,93172,-2509
KR_7768959668,0.0,0.0,7000,7000,0
KR_7768959668,60.007,1.0,7497,7015,482
KR_7768959668,120.024,2.0,11087,9844,1243
KR_7768959668,180.105,3.0,13814,14031,-217
KR_7768959668,240.133,4.0,18390,16961,1429
KR_7768959668,300.14,5.0,20972,19518,1454
KR_7768959668,360.166,6.0,24051,23222,829
KR_7768959668,420.176,7.0,27613,25712,1901
KR_7768959668,480.207,8.0,30404,28257,2147
KR_7768959668,540.237,9.0,34054,32155,1899
KR_7768959668,600.26,10.0,38077,34979,3098
KR_7768959668,660.293,11.0,41629,37785,3844
KR_7768959668,720.322,12.01,45296,42176,3120
KR_7768959668,780.348,13.01,48932,45459,3473
KR_7768959668,840.371,14.01,53377,49029,4348
KR_7768959668,900.404,15.01,56109,52437,3672
KR_7768959668,945.544,15.76,58697,53859,4838
KR_7724131072,0.0,0.0,7000,7000,0
KR_7724131072,60.02,1.0,7015,7041,-26
KR_7724131072,120.048,2.0,9303,9908,-605
KR_7724131072,180.124,3.0,11759,12770,-1011
KR_7724131072,240.147,4.0,14910,15778,-868
KR_7724131072,300.172,5.0,17462,18287,-825
KR_7724131072,360.172,6.0,20421,22122,-1701
KR_7724131072,420.181,7.0,24895,25025,-130
KR_7724131072,480.205,8.0,27678,28613,-935
KR_7724131072,540.234,9.0,31603,31694,-91
KR_7724131072,600.257,10.0,34683,34516,167
KR_7724131072,660.29,11.0,37344,38358,-1014
KR_7724131072,720.314,12.01,41661,41223,438
KR_7724131072,780.344,13.01,45413,44948,465
KR_7724131072,840.348,14.01,48258,47189,1069
KR_7724131072,900.382,15.01,51961,49921,2040
KR_7724131072,960.389,16.01,54326,52690,1636
KR_7724131072,1020.405,17.01,57716,56683,1033
KR_7724131072,1080.429,18.01,61994,60126,1868
KR_7724131072,1140.443,19.01,64509,62827,1682
KR_7724131072,1196.184,19.94,68707,65384,3323
KR_7741094485,0.0,0.0,7000,7000,0
KR_7741094485,60.008,1.0,7030,7805,-775
KR_7741094485,120.038,2.0,12281,11690,591
KR_7741094485,180.12,3.0,16010,15436,574
KR_7741094485,240.145,4.0,19103,17975,1128
KR_7741094485,300.152,5.0,21764,20295,1469
KR_7741094485,360.162,6.0,26199,24058,2141
KR_7741094485,420.163,7.0,30339,27017,3322
KR_7741094485,480.166,8.0,33273,30033,3240
KR_7741094485,540.167,9.0,37427,33370,4057
KR_7741094485,600.189,10.0,41581,37559,4022
KR_7741094485,660.191,11.0,46505,40871,5634
KR_7741094485,720.194,12.0,49543,43757,5786
KR_7741094485,780.225,13.0,52838,46515,6323
KR_7741094485,840.243,14.0,55374,52050,3324
KR_7741094485,900.26,15.0,59488,55271,4217
KR_7741094485,960.286,16.0,62673,57960,4713
KR_7741094485,1020.306,17.01,65409,62220,3189
KR_7741094485,1080.306,18.01,68658,65920,2738
KR_7741094485,1140.314,19.01,71336,70079,1257
KR_7741094485,1145.725,19.1,71501,70294,1207
KR_7778058383,0.0,0.0,7000,7000,0
KR_7778058383,60.021,1.0,7036,7015,21
KR_7778058383,120.023,2.0,9917,9274,643
KR_7778058383,180.042,3.0,12841,11645,1196
KR_7778058383,240.075,4.0,16384,14106,2278
KR_7778058383,300.156,5.0,19670,17627,2043
KR_7778058383,360.175,6.0,22035,20496,1539
KR_7778058383,420.19,7.0,26825,24114,2711
KR_7778058383,480.209,8.0,30156,27955,2201
KR_7778058383,540.221,9.0,33039,31717,1322
KR_7778058383,600.252,10.0,35693,34202,1491
KR_7778058383,660.264,11.0,40812,38190,2622
KR_7778058383,720.283,12.0,43889,41557,2332
KR_7778058383,780.315,13.01,46424,44217,2207
KR_7778058383,840.343,14.01,49252,47900,1352
KR_7778058383,900.344,15.01,53976,51324,2652
KR_7778058383,960.369,16.01,57611,53824,3787
KR_7778058383,1020.381,17.01,61843,58100,3743
KR_7778058383,1080.414,18.01,65123,61727,3396
KR_7778058383,1140.44,19.01,68340,64723,3617
KR_7778058383,1200.448,20.01,70914,69997,917
KR_7778058383,1220.59,20.34,71609,71724,-115
KR_7753130953,0.0,0.0,7000,7000,0
KR_7753130953,60.024,1.0,7015,7015,0
KR_7753130953,120.05,2.0,9910,9775,135
KR_7753130953,180.097,3.0,13465,13407,58
KR_7753130953,240.102,4.0,17770,17146,624
KR_7753130953,300.125,5.0,21207,19995,1212
KR_7753130953,360.147,6.0,24594,24832,-238
KR_7753130953,420.176,7.0,27557,28612,-1055
KR_7753130953,480.193,8.0,31658,31355,303
KR_7753130953,540.22,9.0,35414,34577,837
KR_7753130953,600.247,10.0,39536,38534,1002
KR_7753130953,660.26,11.0,43521,41999,1522
KR_7753130953,720.28,12.0,47336,46352,984
KR_7753130953,780.3,13.0,49699,49945,-246
KR_7753130953,840.318,14.01,53181,52685,496
KR_7753130953,900.349,15.01,55637,56211,-574
KR_7753130953,960.369,16.01,61196,58395,2801
KR_7753130953,960.837,16.01,61211,58410,2801
KR_7771303007,0.0,0.0,7000,7000,0
KR_7771303007,60.032,1.0,7015,7015,0
KR_7771303007,120.063,2.0,11046,9917,1129
KR_7771303007,180.132,3.0,14879,13063,1816
KR_7771303007,240.16,4.0,18875,16594,2281
KR_7771303007,300.167,5.0,23554,19511,4043
KR_7771303007,360.191,6.0,26379,24934,1445
KR_7771303007,420.215,7.0,29440,27465,1975
KR_7771303007,480.239,8.0,32024,30652,1372
KR_7771303007,540.245,9.0,36158,33674,2484
KR_7771303007,600.269,10.0,40585,35781,4804
KR_7771303007,660.278,11.0,44333,39051,5282
KR_7771303007,720.305,12.01,47376,41797,5579
KR_7771303007,752.471,12.54,50666,42834,7832
KR_7778247143,0.0,0.0,7000,7000,0
KR_7778247143,60.025,1.0,7015,7015,0
KR_7778247143,120.026,2.0,9787,9688,99
KR_7778247143,180.046,3.0,12373,13337,-964
KR_7778247143,240.067,4.0,15244,16543,-1299
KR_7778247143,300.154,5.0,18929,20006,-1077
KR_7778247143,360.156,6.0,22578,22641,-63
KR_7778247143,420.188,7.0,25402,26424,-1022
KR_7778247143,480.21,8.0,28329,30793,-2464
KR_7778247143,496.443,8.27,28659,31559,-2900
KR_7766018391,0.0,0.0,7000,7000,0
KR_7766018391,60.023,1.0,7015,7885,-870
KR_7766018391,120.039,2.0,11001,12137,-1136
KR_7766018391,180.053,3.0,13401,15117,-1716
KR_7766018391,240.056,4.0,15797,18566,-2769
KR_7766018391,300.069,5.0,18976,22172,-3196
KR_7766018391,360.07,6.0,21885,24545,-2660
KR_7766018391,420.085,7.0,24089,29076,-4987
KR_7766018391,480.086,8.0,27361,31359,-3998
KR_7766018391,540.098,9.0,31386,34942,-3556
KR_7766018391,551.92,9.2,32108,36029,-3921
KR_7625506739,0.0,0.0,7000,7000,0
KR_7625506739,60.03,1.0,7015,7015,0
KR_7625506739,120.059,2.0,9270,9752,-482
KR_7625506739,180.141,3.0,12795,13051,-256
KR_7625506739,240.163,4.0,16180,16130,50
KR_7625506739,300.191,5.0,19022,19298,-276
KR_7625506739,360.218,6.0,22216,22687,-471
KR_7625506739,420.251,7.0,24553,25947,-1394
KR_7625506739,480.277,8.0,27133,29899,-2766
KR_7625506739,540.282,9.0,31601,32558,-957
KR_7625506739,600.306,10.01,34195,35913,-1718
KR_7625506739,660.308,11.01,39106,38891,215
KR_7625506739,720.328,12.01,41456,42043,-587
KR_7625506739,780.361,13.01,43932,47428,-3496
KR_7625506739,840.383,14.01,47275,49699,-2424
KR_7625506739,900.401,15.01,50479,52810,-2331
KR_7625506739,960.424,16.01,53841,57562,-3721
KR_7625506739,1020.435,17.01,56826,59552,-2726
KR_7625506739,1080.439,18.01,60601,63088,-2487
KR_7625506739,1140.44,19.01,63153,66261,-3108
KR_7625506739,1200.473,20.01,66642,68710,-2068
KR_7625506739,1260.495,21.01,69835,72209,-2374
KR_7625506739,1320.517,22.01,72462,75182,-2720
KR_7625506739,1380.523,23.01,76587,77494,-907
KR_7625506739,1440.554,24.01,79729,81764,-2035
KR_7625506739,1456.419,24.27,80194,82318,-2124
KR_7712890614,0.0,0.0,7000,7000,0
KR_7712890614,60.022,1.0,7735,7313,422
KR_7712890614,120.059,2.0,10508,9524,984
KR_7712890614,180.141,3.0,13517,12738,779
KR_7712890614,240.163,4.0,16373,15538,835
KR_7712890614,300.177,5.0,20534,19845,689
KR_7712890614,360.199,6.0,24193,22651,1542
KR_7712890614,420.225,7.0,27629,27217,412
KR_7712890614,480.236,8.0,30563,29537,1026
KR_7712890614,540.252,9.0,35495,32295,3200
KR_7712890614,600.272,10.0,38772,34602,4170
KR_7712890614,660.296,11.0,41891,37148,4743
KR_7712890614,720.298,12.0,44552,40390,4162
KR_7712890614,780.309,13.01,49476,44072,5404
KR_7712890614,840.326,14.01,52512,47370,5142
KR_7712890614,900.35,15.01,56195,50020,6175
KR_7712890614,960.359,16.01,59796,52863,6933
KR_7712890614,1020.361,17.01,63011,57412,5599
KR_7712890614,1080.37,18.01,66205,60218,5987
KR_7712890614,1140.375,19.01,70845,62671,8174
KR_7712890614,1140.876,19.01,70860,62686,8174
KR_7749312247,0.0,0.0,7000,7000,0
KR_7749312247,60.012,1.0,8265,8167,98
KR_7749312247,120.029,2.0,10842,11125,-283
KR_7749312247,180.101,3.0,13861,13607,254
KR_7749312247,240.113,4.0,17918,17259,659
KR_7749312247,300.141,5.0,21708,21189,519
KR_7749312247,360.166,6.0,24235,23916,319
KR_7749312247,420.18,7.0,27328,27100,228
KR_7749312247,480.202,8.0,30079,29589,490
KR_7749312247,540.203,9.0,32937,32488,449
KR_7749312247,600.224,10.0,35504,36192,-688
KR_7749312247,660.252,11.0,39433,38473,960
KR_7749312247,720.281,12.0,43461,41712,1749
KR_7749312247,780.288,13.0,47073,44822,2251
KR_7749312247,840.319,14.01,50777,49361,1416
KR_7749312247,900.343,15.01,53123,52368,755
KR_7749312247,960.368,16.01,55772,57789,-2017
KR_7749312247,1020.375,17.01,59206,60358,-1152
KR_7749312247,1080.398,18.01,62054,62956,-902
KR_7749312247,1133.858,18.9,63985,67295,-3310
KR_7638245574,0.0,0.0,7000,7000,0
KR_7638245574,60.028,1.0,7015,7421,-406
KR_7638245574,120.051,2.0,9549,10023,-474
KR_7638245574,180.13,3.0,12199,13262,-1063
KR_7638245574,240.162,4.0,15979,16601,-622
KR_7638245574,300.175,5.0,19191,20137,-946
KR_7638245574,360.196,6.0,21824,23857,-2033
KR_7638245574,420.212,7.0,24615,26058,-1443
KR_7638245574,480.234,8.0,27097,30539,-3442
KR_7638245574,540.241,9.0,30344,34066,-3722
KR_7638245574,600.252,10.0,33843,37227,-3384
KR_7638245574,620.368,10.34,34879,38784,-3905
KR_7753211179,0.0,0.0,7000,7000,0
KR_7753211179,60.007,1.0,7015,7015,0
KR_7753211179,120.026,2.0,10910,9223,1687
KR_7753211179,180.04,3.0,13933,12457,1476
KR_7753211179,240.056,4.0,17596,14756,2840
KR_7753211179,300.071,5.0,21439,20487,952
KR_7753211179,360.075,6.0,25385,24637,748
KR_7753211179,420.093,7.0,28793,27654,1139
KR_7753211179,480.104,8.0,31354,32327,-973
KR_7753211179,540.122,9.0,34481,34566,-85
KR_7753211179,600.133,10.0,37994,37980,14
KR_7753211179,660.148,11.0,40731,40215,516
KR_7753211179,720.179,12.0,44078,45277,-1199
KR_7753211179,780.245,13.0,48610,48024,586
KR_7753211179,840.261,14.0,50874,51033,-159
KR_7753211179,900.279,15.0,53070,54487,-1417
KR_7753211179,960.31,16.01,58200,57998,202
KR_7753211179,1005.019,16.75,59543,61731,-2188
KR_7745664291,0.0,0.0,7000,7000,0
KR_7745664291,60.028,1.0,7437,7025,412
KR_7745664291,120.043,2.0,10499,10671,-172
KR_7745664291,180.139,3.0,14706,14300,406
KR_7745664291,240.159,4.0,17204,18279,-1075
KR_7745664291,300.171,5.0,22395,22679,-284
KR_7745664291,360.199,6.0,24911,26358,-1447
KR_7745664291,420.228,7.0,28879,29993,-1114
KR_7745664291,480.251,8.0,31565,32862,-1297
KR_7745664291,540.278,9.0,35289,35520,-231
KR_7745664291,600.305,10.01,38574,38573,1
KR_7745664291,660.324,11.01,42591,41966,625
KR_7745664291,720.347,12.01,45651,46873,-1222
KR_7745664291,780.354,13.01,49660,49805,-145
KR_7745664291,840.382,14.01,52543,53637,-1094
KR_7745664291,900.414,15.01,56216,56755,-539
KR_7745664291,960.441,16.01,59739,60057,-318
KR_7745664291,1020.454,17.01,63123,64494,-1371
KR_7745664291,1080.478,18.01,66172,66664,-492
KR_7745664291,1140.482,19.01,68565,69484,-919
KR_7745664291,1200.512,20.01,72006,72783,-777
KR_7745664291,1260.532,21.01,75409,75550,-141
KR_7745664291,1320.552,22.01,78480,78447,33
KR_7745664291,1372.561,22.88,80656,82998,-2342
KR_7733021147,0.0,0.0,7000,7000,0
KR_7733021147,60.03,1.0,7024,7015,9
KR_7733021147,120.039,2.0,9712,9773,-61
KR_7733021147,180.053,3.0,12766,12879,-113
KR_7733021147,240.056,4.0,16405,15584,821
KR_7733021147,300.071,5.0,18788,19980,-1192
KR_7733021147,360.104,6.0,21562,22448,-886
KR_7733021147,420.18,7.0,25965,26429,-464
KR_7733021147,480.193,8.0,30298,29426,872
KR_7733021147,540.194,9.0,34192,33205,987
KR_7733021147,600.21,10.0,37052,35757,1295
KR_7733021147,660.238,11.0,41461,39790,1671
KR_7733021147,720.252,12.0,45416,41915,3501
KR_7733021147,766.311,12.77,50137,44744,5393
KR_7745957571,0.0,0.0,7000,7000,0
KR_7745957571,60.023,1.0,7015,7015,0
KR_7745957571,120.056,2.0,10284,10277,7
KR_7745957571,180.119,3.0,15220,13282,1938
KR_7745957571,240.137,4.0,20125,17647,2478
KR_7745957571,300.157,5.0,22610,20207,2403
KR_7745957571,360.185,6.0,26156,23028,3128
KR_7745957571,420.203,7.0,29290,26183,3107
KR_7745957571,480.229,8.0,33300,29593,3707
KR_7745957571,540.23,9.0,36171,32336,3835
KR_7745957571,600.248,10.0,39448,35200,4248
KR_7745957571,660.258,11.0,43927,37798,6129
KR_7745957571,720.275,12.0,46949,40945,6004
KR_7745957571,743.125,12.39,48328,41626,6702
KR_7725526528,0.0,0.0,7000,7000,0
KR_7725526528,60.009,1.0,7015,7015,0
KR_7725526528,120.03,2.0,10890,9657,1233
KR_7725526528,180.081,3.0,14127,12312,1815
KR_7725526528,240.098,4.0,18494,16174,2320
KR_7725526528,300.118,5.0,22481,20557,1924
KR_7725526528,360.133,6.0,25067,23068,1999
KR_7725526528,420.134,7.0,28398,25318,3080
KR_7725526528,480.164,8.0,32276,29189,3087
KR_7725526528,540.189,9.0,37249,32265,4984
KR_7725526528,600.194,10.0,39881,34950,4931
KR_7725526528,660.195,11.0,44820,38251,6569
KR_7725526528,720.219,12.0,47606,41073,6533
KR_7725526528,780.241,13.0,50461,43315,7146
KR_7725526528,840.259,14.0,55835,45463,10372
KR_7725526528,900.276,15.0,58123,50054,8069
KR_7725526528,960.308,16.01,62664,53197,9467
KR_7725526528,976.657,16.28,63687,54002,9685
KR_7769913778,0.0,0.0,7000,7000,0
KR_7769913778,60.008,1.0,7015,7034,-19
KR_7769913778,120.035,2.0,10219,10268,-49
KR_7769913778,180.113,3.0,14345,13659,686
KR_7769913778,240.137,4.0,18613,16715,1898
KR_7769913778,300.162,5.0,21484,19207,2277
KR_7769913778,360.171,6.0,25253,23398,1855
KR_7769913778,420.199,7.0,28261,27168,1093
KR_7769913778,480.204,8.0,31586,29980,1606
KR_7769913778,540.227,9.0,34820,33668,1152
KR_7769913778,600.26,10.0,37453,37073,380
KR_7769913778,660.291,11.0,42085,40040,2045
KR_7769913778,720.316,12.01,45048,44565,483
KR_7769913778,780.323,13.01,48342,49116,-774
KR_7769913778,840.351,14.01,52261,52805,-544
KR_7769913778,900.379,15.01,56043,55990,53
KR_7769913778,960.403,16.01,58383,60034,-1651
KR_7769913778,1020.423,17.01,62402,62286,116
KR_7769913778,1080.428,18.01,65582,66590,-1008
KR_7769913778,1140.434,19.01,68023,69271,-1248
KR_7769913778,1200.138,20.0,70990,73897,-2907
KR_7767237993,0.0,0.0,7000,7000,0
KR_7767237993,60.012,1.0,7015,8611,-1596
KR_7767237993,120.019,2.0,10224,11633,-1409
KR_7767237993,180.019,3.0,12807,14639,-1832
KR_7767237993,240.037,4.0,16987,17470,-483
KR_7767237993,300.126,5.0,19576,20798,-1222
KR_7767237993,360.15,6.0,22994,22987,7
KR_7767237993,420.168,7.0,26786,26048,738
KR_7767237993,480.199,8.0,29577,30124,-547
KR_7767237993,540.208,9.0,33681,34565,-884
KR_7767237993,600.239,10.0,37202,37087,115
KR_7767237993,660.266,11.0,40048,40783,-735
KR_7767237993,720.278,12.0,42600,44139,-1539
KR_7767237993,780.284,13.0,45807,46559,-752
KR_7767237993,840.294,14.0,49865,49147,718
KR_7767237993,869.984,14.5,52708,50082,2626
KR_7744142992,0.0,0.0,7000,7000,0
KR_7744142992,60.001,1.0,7015,7015,0
KR_7744142992,120.014,2.0,9810,10522,-712
KR_7744142992,180.032,3.0,12437,12958,-521
KR_7744142992,240.049,4.0,15611,16923,-1312
KR_7744142992,300.135,5.0,18950,20390,-1440
KR_7744142992,360.152,6.0,22925,24252,-1327
KR_7744142992,420.168,7.0,26038,27542,-1504
KR_7744142992,480.193,8.0,28801,30560,-1759
KR_7744142992,540.216,9.0,32645,34335,-1690
KR_7744142992,600.24,10.0,35376,38739,-3363
KR_7744142992,660.248,11.0,39110,42236,-3126
KR_7744142992,720.258,12.0,41630,45526,-3896
KR_7744142992,780.286,13.0,44168,48438,-4270
KR_7744142992,840.312,14.01,47382,50952,-3570
KR_7744142992,870.74,14.51,48881,53718,-4837
KR_7747516161,0.0,0.0,7000,7000,0
KR_7747516161,60.015,1.0,7015,7015,0
KR_7747516161,120.021,2.0,9288,9310,-22
KR_7747516161,180.039,3.0,12687,12500,187
KR_7747516161,240.055,4.0,16265,15284,981
KR_7747516161,300.123,5.0,20694,19212,1482
KR_7747516161,360.142,6.0,24003,23162,841
KR_7747516161,420.166,7.0,27989,27016,973
KR_7747516161,480.189,8.0,31875,30704,1171
KR_7747516161,540.212,9.0,34865,33555,1310
KR_7747516161,600.232,10.0,37930,38255,-325
KR_7747516161,660.262,11.0,41012,42075,-1063
KR_7747516161,720.283,12.0,44030,44589,-559
KR_7747516161,780.306,13.01,48170,49195,-1025
KR_7747516161,840.32,14.01,51253,52530,-1277
KR_7747516161,900.335,15.01,54725,55758,-1033
KR_7747516161,960.348,16.01,57871,59495,-1624
KR_7747516161,1020.376,17.01,61841,62216,-375
KR_7747516161,1080.378,18.01,64923,65769,-846
KR_7747516161,1140.379,19.01,68397,69286,-889
KR_7747516161,1200.407,20.01,70601,73107,-2506
KR_7747516161,1239.771,20.66,71786,76211,-4425
KR_7731674228,0.0,0.0,7000,7000,0
KR_7731674228,60.03,1.0,7015,7015,0
KR_7731674228,120.038,2.0,9844,10169,-325
KR_7731674228,180.056,3.0,12125,12783,-658
KR_7731674228,240.061,4.0,16928,16182,746
KR_7731674228,300.084,5.0,19572,20172,-600
KR_7731674228,360.102,6.0,23615,23343,272
KR_7731674228,420.166,7.0,26380,25730,650
KR_7731674228,480.185,8.0,29557,28982,575
KR_7731674228,540.209,9.0,34051,31647,2404
KR_7731674228,600.228,10.0,37876,34595,3281
KR_7731674228,660.239,11.0,40250,36983,3267
KR_7731674228,720.262,12.0,44679,41318,3361
KR_7731674228,780.269,13.0,48251,44653,3598
KR_7731674228,840.296,14.0,52213,48529,3684
KR_7731674228,900.307,15.01,55397,51546,3851
KR_7731674228,960.334,16.01,57949,54485,3464
KR_7731674228,1020.352,17.01,61759,56688,5071
KR_7731674228,1028.935,17.15,62395,56943,5452
KR_7745918974,0.0,0.0,7000,7000,0
KR_7745918974,60.008,1.0,7015,7015,0
KR_7745918974,120.031,2.0,10103,9382,721
KR_7745918974,180.103,3.0,14058,13717,341
KR_7745918974,240.132,4.0,16949,16290,659
KR_7745918974,300.151,5.0,21012,19026,1986
KR_7745918974,360.173,6.0,24287,22980,1307
KR_7745918974,420.205,7.0,27328,26296,1032
KR_7745918974,480.223,8.0,31031,30153,878
KR_7745918974,540.256,9.0,33312,34289,-977
KR_7745918974,600.27,10.0,38178,37750,428
KR_7745918974,660.277,11.0,41881,40760,1121
KR_7745918974,720.291,12.0,45502,44242,1260
KR_7745918974,780.295,13.0,47982,47349,633
KR_7745918974,840.309,14.01,51195,50039,1156
KR_7745918974,900.319,15.01,55768,52147,3621
KR_7745918974,960.333,16.01,59143,55165,3978
KR_7745918974,1020.351,17.01,62643,58899,3744
KR_7745918974,1080.374,18.01,66227,61419,4808
KR_7745918974,1140.382,19.01,69693,63947,5746
KR_7745918974,1170.874,19.51,72368,64920,7448
KR_7747489718,0.0,0.0,7000,7000,0
KR_7747489718,60.0,1.0,7015,7015,0
KR_7747489718,120.019,2.0,9741,9307,434
KR_7747489718,180.107,3.0,12543,11865,678
KR_7747489718,240.128,4.0,16318,15164,1154
KR_7747489718,300.144,5.0,20053,18331,1722
KR_7747489718,360.17,6.0,23001,21317,1684
KR_7747489718,420.201,7.0,26995,24789,2206
KR_7747489718,480.222,8.0,29970,28236,1734
KR_7747489718,525.752,8.76,33055,31036,2019
KR_7777176005,0.0,0.0,7000,7000,0
KR_7777176005,60.024,1.0,7015,7015,0
KR_7777176005,120.033,2.0,10206,10156,50
KR_7777176005,180.051,3.0,13480,12799,681
KR_7777176005,240.064,4.0,16329,16459,-130
KR_7777176005,300.13,5.0,18968,18995,-27
KR_7777176005,360.132,6.0,22572,22632,-60
KR_7777176005,420.138,7.0,25605,24953,652
KR_7777176005,480.16,8.0,29568,28312,1256
KR_7777176005,540.188,9.0,33830,32307,1523
KR_7777176005,600.203,10.0,36304,35186,1118
KR_7777176005,660.211,11.0,40318,38876,1442
KR_7777176005,720.229,12.0,43558,41463,2095
KR_7777176005,780.248,13.0,46320,44547,1773
KR_7777176005,840.265,14.0,49366,48183,1183
KR_7777176005,900.291,15.0,52222,50858,1364
KR_7777176005,960.307,16.01,57764,53416,4348
KR_7777176005,1020.313,17.01,61724,55615,6109
KR_7777176005,1035.642,17.26,62610,57378,5232
KR_7741901596,0.0,0.0,7000,7000,0
KR_7741901596,60.02,1.0,7512,7015,497
KR_7741901596,120.043,2.0,10301,9233,1068
KR_7741901596,180.112,3.0,13951,12939,1012
KR_7741901596,240.145,4.0,18248,17213,1035
KR_7741901596,300.159,5.0,21505,20405,1100
KR_7741901596,360.162,6.0,24155,24321,-166
KR_7741901596,420.18,7.0,28937,27891,1046
KR_7741901596,480.201,8.0,31898,31142,756
KR_7741901596,540.209,9.0,35976,34556,1420
KR_7741901596,600.225,10.0,38739,38443,296
KR_7741901596,660.236,11.0,41813,41446,367
KR_7741901596,720.246,12.0,46237,44943,1294
KR_7741901596,780.258,13.0,48326,49314,-988
KR_7741901596,840.276,14.0,52512,51367,1145
KR_7741901596,900.285,15.0,54966,54429,537
KR_7741901596,960.305,16.01,58271,57879,392
KR_7741901596,1020.337,17.01,62156,60485,1671
KR_7741901596,1045.826,17.43,64674,61650,3024
KR_7778374213,0.0,0.0,7000,7000,0
KR_7778374213,60.022,1.0,7015,7015,0
KR_7778374213,120.039,2.0,9952,10516,-564
KR_7778374213,180.126,3.0,13679,14706,-1027
KR_7778374213,240.129,4.0,16872,18368,-1496
KR_7778374213,300.165,5.0,20518,21320,-802
KR_7778374213,360.191,6.0,24065,24850,-785
KR_7778374213,420.211,7.0,26684,27226,-542
KR_7778374213,480.219,8.0,30869,32177,-1308
KR_7778374213,540.222,9.0,34831,34369,462
KR_7778374213,600.227,10.0,38187,38709,-522
KR_7778374213,660.228,11.0,41348,40908,440
KR_7778374213,720.261,12.0,44103,43262,841
KR_7778374213,780.294,13.0,46525,47184,-659
KR_7778374213,840.324,14.01,50337,51574,-1237
KR_7778374213,900.333,15.01,54022,55396,-1374
KR_7778374213,960.357,16.01,58151,58154,-3
KR_7778374213,1020.382,17.01,60916,60930,-14
KR_7778374213,1080.383,18.01,62855,65830,-2975
KR_7778374213,1087.208,18.12,63065,66436,-3371
KR_7766495955,0.0,0.0,7000,7000,0
KR_7766495955,60.023,1.0,7015,7015,0
KR_7766495955,120.036,2.0,10342,9286,1056
KR_7766495955,180.056,3.0,13189,13106,83
KR_7766495955,240.084,4.0,16921,16638,283
KR_7766495955,300.157,5.0,20950,19222,1728
KR_7766495955,360.177,6.0,23334,21826,1508
KR_7766495955,420.179,7.0,27557,24161,3396
KR_7766495955,480.2,8.0,32206,27491,4715
KR_7766495955,540.203,9.0,35097,30580,4517
KR_7766495955,600.229,10.0,37806,35171,2635
KR_7766495955,660.25,11.0,42286,39039,3247
KR_7766495955,720.273,12.0,45402,41290,4112
KR_7766495955,746.424,12.44,47722,42070,5652
KR_7747353557,0.0,0.0,7000,7000,0
KR_7747353557,60.029,1.0,7527,7015,512
KR_7747353557,120.06,2.0,9962,10104,-142
KR_7747353557,180.129,3.0,13594,12824,770
KR_7747353557,240.132,4.0,17409,17200,209
KR_7747353557,300.161,5.0,21518,20437,1081
KR_7747353557,360.193,6.0,24223,23498,725
KR_7747353557,420.199,7.0,27790,26839,951
KR_7747353557,480.228,8.0,29980,32306,-2326
KR_7747353557,540.245,9.0,34788,34502,286
KR_7747353557,600.247,10.0,37107,37998,-891
KR_7747353557,660.252,11.0,40727,41338,-611
KR_7747353557,720.281,12.0,44815,44328,487
KR_7747353557,780.294,13.0,47676,47633,43
KR_7747353557,840.309,14.01,50863,49938,925
KR_7747353557,900.31,15.01,54305,54025,280
KR_7747353557,960.333,16.01,56706,56756,-50
KR_7747353557,1020.359,17.01,59087,59642,-555
KR_7747353557,1080.386,18.01,62763,63967,-1204
KR_7747353557,1140.398,19.01,67488,66738,750
KR_7747353557,1200.429,20.01,71175,70542,633
KR_7747353557,1260.459,21.01,74651,73507,1144
KR_7747353557,1292.563,21.54,76498,74695,1803
KR_7625476853,0.0,0.0,7000,7000,0
KR_7625476853,60.016,1.0,7015,7015,0
KR_7625476853,120.037,2.0,9470,9312,158
KR_7625476853,180.113,3.0,14275,12289,1986
KR_7625476853,240.122,4.0,16831,15119,1712
KR_7625476853,300.135,5.0,19647,19796,-149
KR_7625476853,360.137,6.0,22311,22199,112
KR_7625476853,420.149,7.0,27097,25900,1197
KR_7625476853,480.172,8.0,30559,30014,545
KR_7625476853,540.179,9.0,33539,32236,1303
KR_7625476853,600.207,10.0,36407,34890,1517
KR_7625476853,660.219,11.0,39930,38540,1390
KR_7625476853,720.225,12.0,43225,41229,1996
KR_7625476853,780.247,13.0,47712,43675,4037
KR_7625476853,787.562,13.13,47962,43885,4077
KR_7724263762,0.0,0.0,7000,7000,0
KR_7724263762,60.013,1.0,7015,7015,0
KR_7724263762,120.029,2.0,9353,9305,48
KR_7724263762,180.099,3.0,11962,11735,227
KR_7724263762,240.119,4.0,14633,14608,25
KR_7724263762,300.141,5.0,17767,17825,-58
KR_7724263762,360.163,6.0,21066,20446,620
KR_7724263762,420.18,7.0,25174,24425,749
KR_7724263762,480.211,8.0,27561,27395,166
KR_7724263762,540.219,9.0,30406,30600,-194
KR_7724263762,600.252,10.0,33469,33732,-263
KR_7724263762,660.275,11.0,37675,37905,-230
KR_7724263762,720.301,12.01,39965,40759,-794
KR_7724263762,780.326,13.01,42445,44477,-2032
KR_7724263762,840.33,14.01,45131,48335,-3204
KR_7724263762,900.36,15.01,49478,51871,-2393
KR_7724263762,960.374,16.01,51774,54730,-2956
KR_7724263762,1020.385,17.01,55043,57881,-2838
KR_7724263762,1080.41,18.01,57443,60562,-3119
KR_7724263762,1140.419,19.01,59803,62990,-3187
KR_7724263762,1200.442,20.01,64647,66397,-1750
KR_7724263762,1260.463,21.01,66847,69092,-2245
KR_7724263762,1320.496,22.01,71825,72276,-451
KR_7724263762,1380.528,23.01,75581,75444,137
KR_7724263762,1411.123,23.52,78620,76344,2276
KR_7742130759,0.0,0.0,7000,7000,0
KR_7742130759,60.013,1.0,7015,7015,0
KR_7742130759,120.028,2.0,10138,9533,605
KR_7742130759,180.113,3.0,13758,12466,1292
KR_7742130759,240.138,4.0,16933,17166,-233
KR_7742130759,300.153,5.0,19983,21240,-1257
KR_7742130759,360.154,6.0,23130,24794,-1664
KR_7742130759,420.157,7.0,27196,27173,23
KR_7742130759,480.17,8.0,29909,31365,-1456
KR_7742130759,540.188,9.0,33712,34703,-991
KR_7742130759,600.21,10.0,35764,39075,-3311
KR_7742130759,660.217,11.0,40204,42801,-2597
KR_7742130759,720.219,12.0,42328,46900,-4572
KR_7742130759,780.234,13.0,47604,48943,-1339
KR_7742130759,840.245,14.0,50022,53263,-3241
KR_7742130759,848.294,14.14,50262,53739,-3477
KR_7644319355,0.0,0.0,7000,7000,0
KR_7644319355,60.009,1.0,7371,7015,356
KR_7644319355,120.032,2.0,9956,9700,256
KR_7644319355,180.112,3.0,13244,13281,-37
KR_7644319355,240.133,4.0,16046,16878,-832
KR_7644319355,300.136,5.0,20330,21253,-923
KR_7644319355,360.154,6.0,22894,23905,-1011
KR_7644319355,420.16,7.0,25734,28366,-2632
KR_7644319355,480.186,8.0,29004,31877,-2873
KR_7644319355,540.207,9.0,32286,35564,-3278
KR_7644319355,600.226,10.0,36446,37963,-1517
KR_7644319355,660.237,11.0,38796,42569,-3773
KR_7644319355,720.263,12.0,43338,44672,-1334
KR_7644319355,780.287,13.0,46529,48022,-1493
KR_7644319355,840.306,14.01,48497,52560,-4063
KR_7644319355,900.321,15.01,52677,56886,-4209
KR_7644319355,960.348,16.01,55016,60872,-5856
KR_7644319355,968.397,16.14,55256,61162,-5906
KR_7763437857,0.0,0.0,7000,7000,0
KR_7763437857,60.012,1.0,7015,7015,0
KR_7763437857,120.043,2.0,10200,11040,-840
KR_7763437857,180.115,3.0,15141,13918,1223
KR_7763437857,240.134,4.0,18173,18099,74
KR_7763437857,300.146,5.0,20989,20658,331
KR_7763437857,360.147,6.0,24467,24761,-294
KR_7763437857,420.177,7.0,27182,27634,-452
KR_7763437857,480.2,8.0,31219,30859,360
KR_7763437857,540.22,9.0,35176,34838,338
KR_7763437857,600.225,10.0,38386,39609,-1223
KR_7763437857,660.237,11.0,42104,43501,-1397
KR_7763437857,720.26,12.0,44492,47990,-3498
KR_7763437857,780.28,13.0,49038,51606,-2568
KR_7763437857,808.057,13.47,49863,53969,-4106
KR_7740309059,0.0,0.0,7000,7000,0
KR_7740309059,60.015,1.0,7023,7015,8
KR_7740309059,120.021,2.0,9745,9382,363
KR_7740309059,180.035,3.0,13245,13024,221
KR_7740309059,240.04,4.0,16937,17783,-846
KR_7740309059,300.13,5.0,19896,20890,-994
KR_7740309059,360.143,6.0,24236,24415,-179
KR_7740309059,420.147,7.0,28128,28685,-557
KR_7740309059,480.163,8.0,31165,32774,-1609
KR_7740309059,540.163,9.0,34777,36579,-1802
KR_7740309059,600.176,10.0,38240,38664,-424
KR_7740309059,660.193,11.0,42119,42211,-92
KR_7740309059,720.217,12.0,44588,47583,-2995
KR_7740309059,780.218,13.0,48935,49524,-589
KR_7740309059,840.251,14.0,51339,53420,-2081
KR_7740309059,900.261,15.0,54099,56105,-2006
KR_7740309059,960.282,16.0,57987,58935,-948
KR_7740309059,1020.288,17.0,60822,63890,-3068
KR_7740309059,1026.5,17.11,61602,64070,-2468
KR_7628742326,0.0,0.0,7000,7000,0
KR_7628742326,60.027,1.0,8978,8598,380
KR_7628742326,120.037,2.0,13056,12427,629
KR_7628742326,180.162,3.0,15978,15743,235
KR_7628742326,240.172,4.0,19978,19145,833
KR_7628742326,300.192,5.0,23634,22936,698
KR_7628742326,360.218,6.0,27426,25890,1536
KR_7628742326,420.22,7.0,29923,29447,476
KR_7628742326,480.237,8.0,33763,32935,828
KR_7628742326,540.25,9.0,38240,35658,2582
KR_7628742326,600.262,10.0,41046,39516,1530
KR_7628742326,660.271,11.0,43328,42646,682
KR_7628742326,720.279,12.0,48111,44838,3273
KR_7628742326,780.284,13.0,51972,48137,3835
KR_7628742326,840.3,14.0,54815,50447,4368
KR_7628742326,900.325,15.01,57980,53931,4049
KR_7628742326,958.562,15.98,62864,56273,6591
KR_7734353450,0.0,0.0,7000,7000,0
KR_7734353450,60.003,1.0,7015,7015,0
KR_7734353450,120.016,2.0,10095,10268,-173
KR_7734353450,180.034,3.0,13502,13384,118
KR_7734353450,240.051,4.0,17392,17478,-86
KR_7734353450,300.138,5.0,20609,20559,50
KR_7734353450,360.162,6.0,24850,23528,1322
KR_7734353450,420.171,7.0,27891,26444,1447
KR_7734353450,480.188,8.0,31855,31926,-71
KR_7734353450,540.195,9.0,35398,35069,329
KR_7734353450,600.218,10.0,39419,39087,332
KR_7734353450,660.228,11.0,42861,42051,810
KR_7734353450,720.254,12.0,47395,45511,1884
KR_7734353450,780.26,13.0,50703,48587,2116
KR_7734353450,840.291,14.0,55025,50787,4238
KR_7734353450,900.298,15.0,58681,53933,4748
KR_7734353450,960.329,16.01,61308,57960,3348
KR_7734353450,1020.361,17.01,65111,60659,4452
KR_7734353450,1080.376,18.01,67916,64216,3700
KR_7734353450,1140.383,19.01,71618,67436,4182
KR_7734353450,1182.347,19.71,73228,69098,4130
KR_7724173013,0.0,0.0,7000,7000,0
KR_7724173013,60.007,1.0,7497,7035,462
KR_7724173013,120.031,2.0,12288,11512,776
KR_7724173013,180.099,3.0,15339,15272,67
KR_7724173013,240.118,4.0,19196,19763,-567
KR_7724173013,300.142,5.0,23158,22761,397
KR_7724173013,360.166,6.0,26373,26931,-558
KR_7724173013,420.19,7.0,29949,29908,41
KR_7724173013,480.219,8.0,33312,32964,348
KR_7724173013,540.235,9.0,35483,37540,-2057
KR_7724173013,600.235,10.0,39832,40473,-641
KR_7724173013,660.244,11.0,43642,43889,-247
KR_7724173013,720.264,12.0,46200,46845,-645
KR_7724173013,780.288,13.0,49668,49995,-327
KR_7724173013,840.307,14.01,52407,53961,-1554
KR_7724173013,900.331,15.01,56357,57094,-737
KR_7724173013,960.355,16.01,59511,60448,-937
KR_7724173013,1020.379,17.01,62644,63382,-738
KR_7724173013,1080.404,18.01,65669,65526,143
KR_7724173013,1140.418,19.01,67930,71402,-3472
KR_7724173013,1147.265,19.12,68140,71844,-3704
KR_7737984311,0.0,0.0,7000,7000,0
KR_7737984311,60.013,1.0,7477,7033,444
KR_7737984311,120.042,2.0,10066,10333,-267
KR_7737984311,180.111,3.0,13585,13160,425
KR_7737984311,240.134,4.0,16501,17457,-956
KR_7737984311,300.154,5.0,19270,20029,-759
KR_7737984311,360.175,6.0,22870,23607,-737
KR_7737984311,420.201,7.0,27404,27394,10
KR_7737984311,480.229,8.0,30863,31026,-163
KR_7737984311,540.254,9.0,34568,34101,467
KR_7737984311,600.274,10.0,37689,37628,61
KR_7737984311,660.276,11.0,39905,41221,-1316
KR_7737984311,720.295,12.0,42657,45467,-2810
KR_7737984311,780.318,13.01,46525,48551,-2026
KR_7737984311,840.338,14.01,48700,51962,-3262
KR_7737984311,884.827,14.75,50234,55739,-5505
KR_7772117194,0.0,0.0,7000,7000,0
KR_7772117194,60.021,1.0,7898,7477,421
KR_7772117194,120.038,2.0,10321,10053,268
KR_7772117194,180.104,3.0,12842,13022,-180
KR_7772117194,240.125,4.0,15555,15331,224
KR_7772117194,300.129,5.0,20248,19282,966
KR_7772117194,360.155,6.0,23377,22327,1050
KR_7772117194,420.167,7.0,26650,25753,897
KR_7772117194,480.195,8.0,32042,30016,2026
KR_7772117194,540.197,9.0,35783,33092,2691
KR_7772117194,600.224,10.0,38998,37092,1906
KR_7772117194,660.225,11.0,41766,40148,1618
KR_7772117194,720.227,12.0,45515,43144,2371
KR_7772117194,780.227,13.0,48281,46004,2277
KR_7772117194,840.248,14.0,53111,48587,4524
KR_7772117194,900.258,15.0,56305,52559,3746
KR_7772117194,960.279,16.0,59695,55047,4648
KR_7772117194,1020.289,17.0,64469,58512,5957
KR_7772117194,1047.243,17.45,65637,60314,5323
KR_7779006266,0.0,0.0,7000,7000,0
KR_7779006266,60.021,1.0,7015,7015,0
KR_7779006266,120.025,2.0,10573,10299,274
KR_7779006266,180.043,3.0,14248,13333,915
KR_7779006266,240.064,4.0,17408,16590,818
KR_7779006266,300.144,5.0,19855,19185,670
KR_7779006266,360.161,6.0,22408,21511,897
KR_7779006266,420.169,7.0,25339,23976,1363
KR_7779006266,480.171,8.0,27957,26729,1228
KR_7779006266,540.183,9.0,31224,30592,632
KR_7779006266,600.205,10.0,34642,34584,58
KR_7779006266,660.213,11.0,39466,37804,1662
KR_7779006266,720.24,12.0,42390,41306,1084
KR_7779006266,780.245,13.0,45410,44285,1125
KR_7779006266,840.268,14.0,48651,47654,997
KR_7779006266,900.278,15.0,52000,50698,1302
KR_7779006266,960.295,16.0,54113,53917,196
KR_7779006266,1020.312,17.01,57859,56542,1317
KR_7779006266,1080.332,18.01,61260,61026,234
KR_7779006266,1140.341,19.01,64820,64402,418
KR_7779006266,1200.362,20.01,68335,67152,1183
KR_7779006266,1260.376,21.01,72148,70226,1922
KR_7779006266,1320.398,22.01,74153,73455,698
KR_7779006266,1364.104,22.74,75867,78005,-2138
KR_7740328131,0.0,0.0,7000,7000,0
KR_7740328131,60.032,1.0,7399,7015,384
KR_7740328131,120.063,2.0,10258,12530,-2272
KR_7740328131,180.121,3.0,14621,15677,-1056
KR_7740328131,240.125,4.0,17888,20722,-2834
KR_7740328131,300.139,5.0,22136,23444,-1308
KR_7740328131,360.155,6.0,25832,28339,-2507
KR_7740328131,420.178,7.0,28079,31095,-3016
KR_7740328131,480.207,8.0,32447,34709,-2262
KR_7740328131,540.219,9.0,35571,38881,-3310
KR_7740328131,600.243,10.0,39444,41586,-2142
KR_7740328131,660.262,11.0,42201,45234,-3033
KR_7740328131,720.274,12.0,44874,49449,-4575
KR_7740328131,780.275,13.0,48374,52237,-3863
KR_7740328131,840.305,14.01,51818,55600,-3782
KR_7740328131,900.321,15.01,54169,59259,-5090
KR_7740328131,960.349,16.01,58701,62739,-4038
KR_7740328131,1020.364,17.01,62737,64879,-2142
KR_7740328131,1080.388,18.01,65189,69125,-3936
KR_7740328131,1140.402,19.01,69087,71904,-2817
KR_7740328131,1200.41,20.01,71878,74487,-2609
KR_7740328131,1260.423,21.01,75001,78684,-3683
KR_7740328131,1320.452,22.01,78141,81026,-2885
KR_7740328131,1380.481,23.01,81741,84138,-2397
KR_7740328131,1413.327,23.56,83789,86956,-3167
KR_7776815095,0.0,0.0,7000,7000,0
KR_7776815095,60.004,1.0,7015,8106,-1091
KR_7776815095,120.012,2.0,11430,10894,536
KR_7776815095,180.034,3.0,14480,13776,704
KR_7776815095,240.038,4.0,17246,16499,747
KR_7776815095,300.056,5.0,20997,20507,490
KR_7776815095,360.078,6.0,23941,23644,297
KR_7776815095,420.158,7.0,27832,26760,1072
KR_7776815095,480.162,8.0,31244,29731,1513
KR_7776815095,540.166,9.0,33846,32364,1482
KR_7776815095,600.181,10.0,37193,35650,1543
KR_7776815095,660.21,11.0,40512,39511,1001
KR_7776815095,720.241,12.0,43107,42923,184
KR_7776815095,780.256,13.0,46665,46496,169
KR_7776815095,840.289,14.0,50240,49863,377
KR_7776815095,900.296,15.0,52230,54695,-2465
KR_7776815095,960.322,16.01,56355,58270,-1915
KR_7776815095,1020.322,17.01,60315,61028,-713
KR_7776815095,1080.333,18.01,63656,64811,-1155
KR_7776815095,1140.344,19.01,67675,67486,189
KR_7776815095,1200.364,20.01,71210,71211,-1
KR_7776815095,1260.379,21.01,73932,73872,60
KR_7776815095,1320.405,22.01,76431,76972,-541
KR_7776815095,1371.36,22.86,78363,80691,-2328
KR_7767613838,0.0,0.0,7000,7000,0
KR_7767613838,60.011,1.0,7015,7015,0
KR_7767613838,120.016,2.0,10582,9456,1126
KR_7767613838,180.033,3.0,13978,13723,255
KR_7767613838,240.058,4.0,17303,17302,1
KR_7767613838,300.133,5.0,20224,20009,215
KR_7767613838,360.149,6.0,23692,23109,583
KR_7767613838,420.151,7.0,27910,26576,1334
KR_7767613838,480.172,8.0,30663,29848,815
KR_7767613838,540.173,9.0,33456,32690,766
KR_7767613838,600.192,10.0,37531,36067,1464
KR_7767613838,660.224,11.0,40116,38635,1481
KR_7767613838,720.243,12.0,43770,42284,1486
KR_7767613838,780.256,13.0,47085,45667,1418
KR_7767613838,840.28,14.0,51235,48235,3000
KR_7767613838,900.296,15.0,54359,51431,2928
KR_7767613838,960.316,16.01,56859,54501,2358
KR_7767613838,1020.342,17.01,62891,57770,5121
KR_7767613838,1080.361,18.01,66066,60245,5821
KR_7767613838,1122.318,18.71,68696,61827,6869
KR_7779582606,0.0,0.0,7000,7000,0
KR_7779582606,60.032,1.0,7015,7015,0
KR_7779582606,120.038,2.0,10458,10324,134
KR_7779582606,180.061,3.0,14368,14046,322
KR_7779582606,240.065,4.0,17719,17486,233
KR_7779582606,300.09,5.0,21341,21435,-94
KR_7779582606,360.116,6.0,24417,24113,304
KR_7779582606,420.2,7.0,28386,26830,1556
KR_7779582606,480.203,8.0,32144,30695,1449
KR_7779582606,540.206,9.0,35366,34896,470
KR_7779582606,600.233,10.0,39312,38887,425
KR_7779582606,660.246,11.0,43517,42038,1479
KR_7779582606,720.26,12.0,46400,45735,665
KR_7779582606,780.28,13.0,50626,48061,2565
KR_7779582606,840.282,14.0,54383,51853,2530
KR_7779582606,900.295,15.0,57275,55610,1665
KR_7779582606,960.327,16.01,61183,57580,3603
KR_7779582606,1020.35,17.01,65555,61476,4079
KR_7779582606,1080.359,18.01,67962,63909,4053
KR_7779582606,1140.375,19.01,70934,67929,3005
KR_7779582606,1200.402,20.01,75115,70081,5034
KR_7779582606,1207.883,20.13,75645,70558,5087
KR_7733032237,0.0,0.0,7000,7000,0
KR_7733032237,60.027,1.0,7437,7015,422
KR_7733032237,120.057,2.0,10877,9185,1692
KR_7733032237,180.131,3.0,14497,12784,1713
KR_7733032237,240.149,4.0,17068,16752,316
KR_7733032237,300.157,5.0,21097,21461,-364
KR_7733032237,360.173,6.0,24867,23964,903
KR_7733032237,420.197,7.0,28352,27485,867
KR_7733032237,480.225,8.0,33075,29676,3399
KR_7733032237,540.238,9.0,36055,34136,1919
KR_7733032237,600.24,10.0,40865,36460,4405
KR_7733032237,660.25,11.0,43483,40083,3400
KR_7733032237,685.574,11.43,45760,40833,4927
KR_7771419853,0.0,0.0,7000,7000,0
KR_7771419853,60.02,1.0,7015,7015,0
KR_7771419853,120.029,2.0,9337,9743,-406
KR_7771419853,180.129,3.0,11956,12165,-209
KR_7771419853,240.137,4.0,14711,14648,63
KR_7771419853,300.165,5.0,17378,17358,20
KR_7771419853,360.185,6.0,19779,20216,-437
KR_7771419853,420.213,7.0,23329,24681,-1352
KR_7771419853,480.245,8.0,27045,27911,-866
KR_7771419853,540.246,9.0,30424,30549,-125
KR_7771419853,600.247,10.0,33761,34003,-242
KR_7771419853,660.28,11.0,37235,36984,251
KR_7771419853,720.291,12.0,40467,39649,818
KR_7771419853,780.324,13.01,43594,42329,1265
KR_7771419853,809.574,13.49,46086,43217,2869
KR_7773355188,0.0,0.0,7000,7000,0
KR_7773355188,60.014,1.0,7025,7015,10
KR_7773355188,120.019,2.0,9733,9788,-55
KR_7773355188,180.036,3.0,13650,12816,834
KR_7773355188,240.042,4.0,16779,15909,870
KR_7773355188,300.046,5.0,19146,20743,-1597
KR_7773355188,360.077,6.0,22329,23336,-1007
KR_7773355188,420.143,7.0,25704,26047,-343
KR_7773355188,480.162,8.0,28906,30488,-1582
KR_7773355188,540.195,9.0,32328,32806,-478
KR_7773355188,600.204,10.0,34925,35482,-557
KR_7773355188,660.241,11.0,38470,38427,43
KR_7773355188,720.264,12.0,40969,41577,-608
KR_7773355188,780.281,13.0,44119,44176,-57
KR_7773355188,840.281,14.0,47595,47282,313
KR_7773355188,900.314,15.01,50507,50333,174
KR_7773355188,960.333,16.01,52689,55111,-2422
KR_7773355188,1020.365,17.01,56103,58845,-2742
KR_7773355188,1080.376,18.01,59127,62065,-2938
KR_7773355188,1140.383,19.01,61769,65906,-4137
KR_7773355188,1159.909,19.33,62204,66575,-4371
KR_7771322031,0.0,0.0,7000,7000,0
KR_7771322031,60.01,1.0,7645,7015,630
KR_7771322031,120.043,2.0,10368,10803,-435
KR_7771322031,180.13,3.0,12963,13114,-151
KR_7771322031,240.161,4.0,15595,17643,-2048
KR_7771322031,300.181,5.0,20168,20833,-665
KR_7771322031,360.191,6.0,22687,25143,-2456
KR_7771322031,420.212,7.0,25112,28894,-3782
KR_7771322031,480.219,8.0,28988,32099,-3111
KR_7771322031,540.231,9.0,31833,36008,-4175
KR_7771322031,600.259,10.0,35110,39485,-4375
KR_7771322031,660.281,11.0,37413,43051,-5638
KR_7771322031,680.089,11.33,38837,44391,-5554
KR_7763476756,0.0,0.0,7000,7000,0
KR_7763476756,60.018,1.0,7015,7015,0
KR_7763476756,120.047,2.0,9602,10158,-556
KR_7763476756,180.113,3.0,12973,13326,-353
KR_7763476756,240.121,4.0,16992,16514,478
KR_7763476756,300.169,5.0,19831,20562,-731
KR_7763476756,360.18,6.0,23650,24427,-777
KR_7763476756,420.2,7.0,26324,27845,-1521
KR_7763476756,480.215,8.0,29571,30291,-720
KR_7763476756,540.248,9.0,31649,34912,-3263
KR_7763476756,600.268,10.0,34253,38425,-4172
KR_7763476756,660.29,11.0,38457,41998,-3541
KR_7763476756,718.579,11.98,41306,45993,-4687
KR_7778456921,0.0,0.0,7000,7000,0
KR_7778456921,60.03,1.0,7702,7397,305
KR_7778456921,120.047,2.0,11063,10749,314
KR_7778456921,180.05,3.0,14212,13611,601
KR_7778456921,240.06,4.0,18003,17179,824
KR_7778456921,300.081,5.0,21769,20055,1714
KR_7778456921,360.107,6.0,25585,24491,1094
KR_7778456921,420.153,7.0,30411,27544,2867
KR_7778456921,480.178,8.0,33881,30455,3426
KR_7778456921,540.262,9.0,36009,36216,-207
KR_7778456921,600.286,10.0,38831,39591,-760
KR_7778456921,660.292,11.0,43340,42512,828
KR_7778456921,720.312,12.01,46050,45384,666
KR_7778456921,780.317,13.01,49994,50192,-198
KR_7778456921,840.337,14.01,52950,52821,129
KR_7778456921,900.347,15.01,56013,58061,-2048
KR_7778456921,960.364,16.01,59189,61020,-1831
KR_7778456921,1007.553,16.79,61166,64824,-3658
KR_7743856494,0.0,0.0,7000,7000,0
KR_7743856494,60.023,1.0,7273,8203,-930
KR_7743856494,120.032,2.0,10884,11844,-960
KR_7743856494,180.051,3.0,14470,15998,-1528
KR_7743856494,240.084,4.0,17258,19048,-1790
KR_7743856494,300.154,5.0,20523,23261,-2738
KR_7743856494,360.157,6.0,24384,26310,-1926
KR_7743856494,420.168,7.0,27794,29645,-1851
KR_7743856494,480.185,8.0,31168,32241,-1073
KR_7743856494,540.193,9.0,34449,35531,-1082
KR_7743856494,600.221,10.0,39002,39238,-236
KR_7743856494,660.245,11.0,42147,42943,-796
KR_7743856494,720.264,12.0,44871,46711,-1840
KR_7743856494,780.264,13.0,48205,49265,-1060
KR_7743856494,840.295,14.0,51843,52761,-918
KR_7743856494,900.32,15.01,54909,56476,-1567
KR_7743856494,960.352,16.01,57832,59364,-1532
KR_7743856494,1020.362,17.01,60937,62884,-1947
KR_7743856494,1080.378,18.01,64431,66161,-1730
KR_7743856494,1140.411,19.01,67018,70556,-3538
KR_7743856494,1184.852,19.75,69769,73658,-3889
KR_7776929477,0.0,0.0,7000,7000,0
KR_7776929477,60.028,1.0,7015,7015,0
KR_7776929477,120.029,2.0,9267,10791,-1524
KR_7776929477,180.047,3.0,13676,13895,-219
KR_7776929477,240.062,4.0,18033,17665,368
KR_7776929477,300.145,5.0,21342,23058,-1716
KR_7776929477,360.149,6.0,24274,27058,-2784
KR_7776929477,420.156,7.0,27934,29683,-1749
KR_7776929477,480.173,8.0,32665,32212,453
KR_7776929477,540.205,9.0,35536,35908,-372
KR_7776929477,600.215,10.0,39290,39259,31
KR_7776929477,660.229,11.0,43120,42947,173
KR_7776929477,720.24,12.0,45655,46412,-757
KR_7776929477,780.252,13.0,48547,48961,-414
KR_7776929477,840.282,14.0,53057,51863,1194
KR_7776929477,900.3,15.0,55379,54872,507
KR_7776929477,960.321,16.01,60908,57676,3232
KR_7776929477,1020.322,17.01,63960,61410,2550
KR_7776929477,1080.347,18.01,67128,63743,3385
KR_7776929477,1117.019,18.62,69196,64992,4204
KR_7778200933,0.0,0.0,7000,7000,0
KR_7778200933,60.023,1.0,7378,7397,-19
KR_7778200933,120.045,2.0,10917,11093,-176
KR_7778200933,180.114,3.0,14360,14030,330
KR_7778200933,240.141,4.0,17835,17868,-33
KR_7778200933,300.165,5.0,20693,20373,320
KR_7778200933,360.182,6.0,23781,23859,-78
KR_7778200933,420.194,7.0,27714,26917,797
KR_7778200933,480.213,8.0,30718,30813,-95
KR_7778200933,540.219,9.0,33498,34268,-770
KR_7778200933,600.237,10.0,37000,37163,-163
KR_7778200933,660.247,11.0,39867,40246,-379
KR_7778200933,720.265,12.0,43736,43251,485
KR_7778200933,780.287,13.0,46553,47894,-1341
KR_7778200933,840.307,14.01,50100,50923,-823
KR_7778200933,900.339,15.01,53172,53912,-740
KR_7778200933,960.366,16.01,57600,57090,510
KR_7778200933,1020.388,17.01,60237,60879,-642
KR_7778200933,1080.409,18.01,63497,64151,-654
KR_7778200933,1140.418,19.01,66205,68179,-1974
KR_7778200933,1157.757,19.3,66793,70308,-3515
KR_7779584169,0.0,0.0,7000,7000,0
KR_7779584169,60.008,1.0,7408,7675,-267
KR_7779584169,120.031,2.0,10549,11023,-474
KR_7779584169,180.13,3.0,13794,14107,-313
KR_7779584169,240.134,4.0,17360,17308,52
KR_7779584169,300.161,5.0,20744,20590,154
KR_7779584169,360.181,6.0,24569,23435,1134
KR_7779584169,420.205,7.0,27399,27054,345
KR_7779584169,480.228,8.0,31299,30665,634
KR_7779584169,540.232,9.0,34650,35027,-377
KR_7779584169,600.253,10.0,37655,37989,-334
KR_7779584169,660.271,11.0,40608,42145,-1537
KR_7779584169,720.303,12.01,44023,45071,-1048
KR_7779584169,780.304,13.01,47308,48335,-1027
KR_7779584169,840.305,14.01,50744,51252,-508
KR_7779584169,900.328,15.01,53584,53693,-109
KR_7779584169,960.351,16.01,58782,56365,2417
KR_7779584169,1020.374,17.01,62172,60757,1415
KR_7779584169,1080.396,18.01,65600,62978,2622
KR_7779584169,1140.412,19.01,68185,65831,2354
KR_7779584169,1200.412,20.01,70312,69569,743
KR_7779584169,1260.441,21.01,73932,72245,1687
KR_7779584169,1320.468,22.01,79049,74557,4492
KR_7779584169,1323.307,22.06,79139,74647,4492
KR_7765671468,0.0,0.0,7000,7000,0
KR_7765671468,60.005,1.0,7675,7015,660
KR_7765671468,120.038,2.0,11321,10623,698
KR_7765671468,180.134,3.0,14706,14487,219
KR_7765671468,240.158,4.0,17822,17340,482
KR_7765671468,300.191,5.0,21266,21341,-75
KR_7765671468,360.22,6.0,24910,24153,757
KR_7765671468,420.224,7.0,28879,27976,903
KR_7765671468,480.242,8.0,32555,30944,1611
KR_7765671468,540.271,9.0,35903,35213,690
KR_7765671468,600.296,10.0,38907,39009,-102
KR_7765671468,660.31,11.01,43269,42001,1268
KR_7765671468,720.334,12.01,46030,47212,-1182
KR_7765671468,780.341,13.01,50025,49675,350
KR_7765671468,840.371,14.01,53809,53258,551
KR_7765671468,900.397,15.01,56710,56193,517
KR_7765671468,960.408,16.01,59717,59402,315
KR_7765671468,1020.439,17.01,62288,62219,69
KR_7765671468,1080.462,18.01,66716,64731,1985
KR_7765671468,1140.49,19.01,69839,68051,1788
KR_7765671468,1200.52,20.01,73497,71096,2401
KR_7765671468,1260.548,21.01,76476,75048,1428
KR_7765671468,1320.574,22.01,79667,78513,1154
KR_7765671468,1380.585,23.01,82429,81938,491
KR_7765671468,1440.599,24.01,85518,86615,-1097
KR_7765671468,1500.631,25.01,88721,89303,-582
KR_7765671468,1560.647,26.01,91663,92635,-972
KR_7765671468,1620.656,27.01,95457,96428,-971
KR_7765671468,1680.685,28.01,98224,101604,-3380
KR_7765671468,1740.707,29.01,102054,104048,-1994
KR_7765671468,1800.722,30.01,105097,108038,-2941
KR_7765671468,1801.891,30.03,105127,108068,-2941
KR_7775379417,0.0,0.0,7000,7000,0
KR_7775379417,60.031,1.0,7015,7015,0
KR_7775379417,120.045,2.0,9453,9341,112
KR_7775379417,180.062,3.0,11971,11930,41
KR_7775379417,240.068,4.0,15399,15627,-228
KR_7775379417,300.085,5.0,18861,20209,-1348
KR_7775379417,360.099,6.0,21969,23254,-1285
KR_7775379417,420.116,7.0,25276,26291,-1015
KR_7775379417,480.12,8.0,27788,29393,-1605
KR_7775379417,540.136,9.0,31662,32906,-1244
KR_7775379417,600.142,10.0,34551,36195,-1644
KR_7775379417,660.16,11.0,37999,40300,-2301
KR_7775379417,720.173,12.0,41363,44006,-2643
KR_7775379417,780.19,13.0,44465,47470,-3005
KR_7775379417,840.211,14.0,47161,50469,-3308
KR_7775379417,900.282,15.0,49524,53918,-4394
KR_7775379417,960.308,16.01,53239,57035,-3796
KR_7775379417,1020.322,17.01,56120,59931,-3811
KR_7775379417,1080.339,18.01,58895,63332,-4437
KR_7775379417,1140.351,19.01,61677,67311,-5634
KR_7775379417,1200.351,20.01,65279,70533,-5254
KR_7775379417,1260.38,21.01,67871,73410,-5539
KR_7775379417,1320.398,22.01,71199,78779,-7580
KR_7775379417,1346.685,22.44,72219,79879,-7660
KR_7770526168,0.0,0.0,7000,7000,0
KR_7770526168,60.03,1.0,7427,7015,412
KR_7770526168,120.054,2.0,10155,9293,862
KR_7770526168,180.11,3.0,14220,12820,1400
KR_7770526168,240.131,4.0,16741,15580,1161
KR_7770526168,300.141,5.0,20313,18548,1765
KR_7770526168,360.162,6.0,24227,23137,1090
KR_7770526168,420.166,7.0,27807,25875,1932
KR_7770526168,480.187,8.0,30857,29854,1003
KR_7770526168,540.189,9.0,34366,32813,1553
KR_7770526168,600.2,10.0,37979,37255,724
KR_7770526168,660.218,11.0,41390,39643,1747
KR_7770526168,720.228,12.0,45331,43696,1635
KR_7770526168,780.238,13.0,48488,46077,2411
KR_7770526168,840.253,14.0,52144,49720,2424
KR_7770526168,900.265,15.0,54985,51967,3018
KR_7770526168,960.282,16.0,59446,54633,4813
KR_7770526168,996.326,16.61,61439,56018,5421
KR_7773485740,0.0,0.0,7000,7000,0
KR_7773485740,60.009,1.0,7015,7689,-674
KR_7773485740,120.022,2.0,9624,10442,-818
KR_7773485740,180.098,3.0,13197,13358,-161
KR_7773485740,240.117,4.0,17012,16117,895
KR_7773485740,300.132,5.0,19763,19774,-11
KR_7773485740,360.158,6.0,23499,22301,1198
KR_7773485740,420.18,7.0,26569,25493,1076
KR_7773485740,480.201,8.0,29521,29430,91
KR_7773485740,540.23,9.0,32479,31805,674
KR_7773485740,600.26,10.0,36260,35410,850
KR_7773485740,660.279,11.0,39256,38647,609
KR_7773485740,720.287,12.0,42746,41321,1425
KR_7773485740,780.29,13.0,45297,44561,736
KR_7773485740,840.308,14.01,48520,46893,1627
KR_7773485740,900.33,15.01,50783,49599,1184
KR_7773485740,960.332,16.01,54209,55530,-1321
KR_7773485740,1020.337,17.01,56910,57822,-912
KR_7773485740,1080.366,18.01,59997,60807,-810
KR_7773485740,1140.367,19.01,62690,65242,-2552
KR_7773485740,1172.202,19.54,63927,67461,-3534
KR_7720205504,0.0,0.0,7000,7000,0
KR_7720205504,60.023,1.0,7808,7774,34
KR_7720205504,120.04,2.0,10652,10973,-321
KR_7720205504,180.137,3.0,13781,14615,-834
KR_7720205504,240.156,4.0,17475,18844,-1369
KR_7720205504,300.182,5.0,22109,22559,-450
KR_7720205504,360.211,6.0,25198,25324,-126
KR_7720205504,420.236,7.0,28329,30149,-1820
KR_7720205504,480.252,8.0,31582,32675,-1093
KR_7720205504,540.256,9.0,35471,35239,232
KR_7720205504,600.269,10.0,38854,38681,173
KR_7720205504,660.285,11.0,42117,43379,-1262
KR_7720205504,720.316,12.01,45060,48427,-3367
KR_7720205504,780.336,13.01,48450,51028,-2578
KR_7720205504,840.354,14.01,52061,53956,-1895
KR_7720205504,900.359,15.01,54948,57738,-2790
KR_7720205504,960.365,16.01,58991,61512,-2521
KR_7720205504,1020.381,17.01,61783,65390,-3607
KR_7720205504,1025.391,17.09,61933,65540,-3607
KR_7745717633,0.0,0.0,7000,7000,0
KR_7745717633,60.002,1.0,7015,7427,-412
KR_7745717633,120.029,2.0,9457,10307,-850
KR_7745717633,180.105,3.0,13214,13328,-114
KR_7745717633,240.13,4.0,15479,16911,-1432
KR_7745717633,300.13,5.0,18012,19221,-1209
KR_7745717633,360.15,6.0,21955,22901,-946
KR_7745717633,420.181,7.0,24694,25471,-777
KR_7745717633,480.209,8.0,28831,28974,-143
KR_7745717633,540.218,9.0,32038,32290,-252
KR_7745717633,600.234,10.0,35507,35195,312
KR_7745717633,660.265,11.0,38865,38094,771
KR_7745717633,720.269,12.0,43260,41845,1415
KR_7745717633,780.286,13.0,46294,45276,1018
KR_7745717633,840.312,14.01,49702,47994,1708
KR_7745717633,900.319,15.01,53253,51283,1970
KR_7745717633,960.343,16.01,56221,54594,1627
KR_7745717633,1020.361,17.01,60085,57643,2442
KR_7745717633,1080.372,18.01,63016,60997,2019
KR_7745717633,1140.374,19.01,65674,63953,1721
KR_7745717633,1200.383,20.01,69127,66626,2501
KR_7745717633,1260.405,21.01,72524,70664,1860
KR_7745717633,1320.429,22.01,75070,74362,708
KR_7745717633,1380.438,23.01,77532,77596,-64
KR_7745717633,1440.452,24.01,82171,80212,1959
KR_7745717633,1453.765,24.23,82626,80677,1949
KR_7778420181,0.0,0.0,7000,7000,0
KR_7778420181,60.011,1.0,7363,7625,-262
KR_7778420181,120.018,2.0,10680,10864,-184
KR_7778420181,180.106,3.0,13090,13345,-255
KR_7778420181,240.117,4.0,17171,16074,1097
KR_7778420181,300.12,5.0,20476,19998,478
KR_7778420181,360.151,6.0,24496,23615,881
KR_7778420181,420.155,7.0,27195,27320,-125
KR_7778420181,480.185,8.0,30609,30547,62
KR_7778420181,540.203,9.0,32920,35627,-2707
KR_7778420181,600.229,10.0,36158,37878,-1720
KR_7778420181,660.251,11.0,38929,40387,-1458
KR_7778420181,720.254,12.0,42439,43973,-1534
KR_7778420181,780.281,13.0,44970,47270,-2300
KR_7778420181,840.309,14.01,49056,49722,-666
KR_7778420181,900.336,15.01,52184,53464,-1280
KR_7778420181,960.343,16.01,55746,58103,-2357
KR_7778420181,1020.356,17.01,58148,60832,-2684
KR_7778420181,1080.384,18.01,61947,63213,-1266
KR_7778420181,1123.062,18.72,63476,66352,-2876
KR_7731642501,0.0,0.0,7000,7000,0
KR_7731642501,60.009,1.0,7775,7015,760
KR_7731642501,120.012,2.0,10373,9971,402
KR_7731642501,180.037,3.0,14059,13679,380
KR_7731642501,240.062,4.0,17844,18063,-219
KR_7731642501,300.145,5.0,21553,21214,339
KR_7731642501,360.171,6.0,25374,23865,1509
KR_7731642501,420.172,7.0,28434,27369,1065
KR_7731642501,480.184,8.0,31367,31439,-72
KR_7731642501,540.207,9.0,35958,34044,1914
KR_7731642501,600.238,10.0,40166,38971,1195
KR_7731642501,660.26,11.0,43106,42344,762
KR_7731642501,720.267,12.0,47388,46182,1206
KR_7731642501,780.295,13.0,51067,50249,818
KR_7731642501,840.303,14.01,54131,52497,1634
KR_7731642501,900.307,15.01,56711,55857,854
KR_7731642501,960.323,16.01,59707,60156,-449
KR_7731642501,1020.352,17.01,63695,62813,882
KR_7731642501,1080.356,18.01,66124,66788,-664
KR_7731642501,1088.43,18.14,66364,67381,-1017
KR_7734408185,0.0,0.0,7000,7000,0
KR_7734408185,60.018,1.0,7015,7015,0
KR_7734408185,120.025,2.0,9386,9337,49
KR_7734408185,180.109,3.0,13217,12846,371
KR_7734408185,240.119,4.0,16339,15134,1205
KR_7734408185,300.125,5.0,20160,19596,564
KR_7734408185,360.154,6.0,22533,22073,460
KR_7734408185,420.167,7.0,26196,26221,-25
KR_7734408185,480.186,8.0,29406,29615,-209
KR_7734408185,540.188,9.0,31910,31987,-77
KR_7734408185,600.207,10.0,35467,36385,-918
KR_7734408185,660.238,11.0,38235,38839,-604
KR_7734408185,720.261,12.0,41596,43768,-2172
KR_7734408185,780.274,13.0,45502,47627,-2125
KR_7734408185,840.292,14.0,48117,50436,-2319
KR_7734408185,900.308,15.01,50708,52820,-2112
KR_7734408185,960.34,16.01,53104,55568,-2464
KR_7734408185,1020.342,17.01,56708,59329,-2621
KR_7734408185,1080.362,18.01,59278,62096,-2818
KR_7734408185,1140.378,19.01,62087,65510,-3423
KR_7734408185,1200.389,20.01,65940,69328,-3388
KR_7734408185,1260.394,21.01,69340,72320,-2980
KR_7734408185,1320.424,22.01,71578,76209,-4631
KR_7734408185,1360.412,22.67,73423,78760,-5337
KR_7740200626,0.0,0.0,7000,7000,0
KR_7740200626,60.031,1.0,7427,7015,412
KR_7740200626,120.056,2.0,10978,10057,921
KR_7740200626,180.118,3.0,13670,13258,412
KR_7740200626,240.146,4.0,17358,17157,201
KR_7740200626,300.172,5.0,20417,20763,-346
KR_7740200626,360.199,6.0,22774,24530,-1756
KR_7740200626,420.221,7.0,27132,27984,-852
KR_7740200626,480.238,8.0,29354,31837,-2483
KR_7740200626,540.253,9.0,33285,35405,-2120
KR_7740200626,600.27,10.0,36186,39417,-3231
KR_7740200626,660.297,11.0,39364,42401,-3037
KR_7740200626,720.302,12.01,42848,45634,-2786
KR_7740200626,780.312,13.01,45823,47918,-2095
KR_7740200626,840.33,14.01,49501,51395,-1894
KR_7740200626,900.336,15.01,52594,54443,-1849
KR_7740200626,960.347,16.01,54906,57512,-2606
KR_7740200626,1020.371,17.01,59181,59697,-516
KR_7740200626,1080.397,18.01,62068,63721,-1653
KR_7740200626,1134.843,18.91,64852,67686,-2834
KR_7745948652,0.0,0.0,7000,7000,0
KR_7745948652,60.03,1.0,7015,7015,0
KR_7745948652,106.385,1.77,8902,9918,-1016
KR_7771373243,0.0,0.0,7000,7000,0
KR_7771373243,60.005,1.0,7015,7025,-10
KR_7771373243,120.009,2.0,10169,9972,197
KR_7771373243,180.033,3.0,12755,13487,-732
KR_7771373243,240.059,4.0,16918,16270,648
KR_7771373243,300.06,5.0,20204,19138,1066
KR_7771373243,360.089,6.0,23238,21994,1244
KR_7771373243,420.18,7.0,26592,25315,1277
KR_7771373243,480.208,8.0,29890,29661,229
KR_7771373243,540.222,9.0,32843,32918,-75
KR_7771373243,600.252,10.0,36969,36435,534
KR_7771373243,660.263,11.0,40548,40660,-112
KR_7771373243,720.288,12.0,43708,43366,342
KR_7771373243,780.309,13.01,46273,47048,-775
KR_7771373243,840.339,14.01,49694,50235,-541
KR_7771373243,900.362,15.01,53196,52722,474
KR_7771373243,960.372,16.01,57249,55159,2090
KR_7771373243,1020.404,17.01,60520,58156,2364
KR_7771373243,1080.426,18.01,63477,61945,1532
KR_7771373243,1105.848,18.43,65219,62720,2499
KR_7769195485,0.0,0.0,7000,7000,0
KR_7769195485,60.007,1.0,7477,7015,462
KR_7769195485,120.034,2.0,11585,10741,844
KR_7769195485,180.098,3.0,13957,13314,643
KR_7769195485,240.127,4.0,18059,15466,2593
KR_7769195485,300.151,5.0,21325,19909,1416
KR_7769195485,360.175,6.0,24552,22482,2070
KR_7769195485,420.208,7.0,26915,26698,217
KR_7769195485,480.23,8.0,31587,30908,679
KR_7769195485,540.252,9.0,34163,33781,382
KR_7769195485,600.269,10.0,38437,36724,1713
KR_7769195485,660.298,11.0,42308,39817,2491
KR_7769195485,720.318,12.01,44665,44035,630
KR_7769195485,780.346,13.01,47408,46599,809
KR_7769195485,840.372,14.01,50163,49117,1046
KR_7769195485,900.376,15.01,53399,52826,573
KR_7769195485,960.402,16.01,56020,56602,-582
KR_7769195485,1020.43,17.01,60814,58553,2261
KR_7769195485,1080.459,18.01,62888,62886,2
KR_7769195485,1113.892,18.56,64269,66072,-1803
KR_7753237232,0.0,0.0,7000,7000,0
KR_7753237232,60.032,1.0,7323,7427,-104
KR_7753237232,120.057,2.0,11348,10882,466
KR_7753237232,180.144,3.0,15327,15273,54
KR_7753237232,240.167,4.0,19508,19726,-218
KR_7753237232,300.182,5.0,22717,23424,-707
KR_7753237232,360.2,6.0,26376,26266,110
KR_7753237232,420.23,7.0,30005,30079,-74
KR_7753237232,480.248,8.0,32778,32689,89
KR_7753237232,540.268,9.0,36348,36379,-31
KR_7753237232,600.285,10.0,39480,39580,-100
KR_7753237232,660.297,11.0,42601,44461,-1860
KR_7753237232,720.314,12.01,46269,47063,-794
KR_7753237232,780.332,13.01,49029,52046,-3017
KR_7753237232,840.354,14.01,52247,55088,-2841
KR_7753237232,900.385,15.01,55410,59671,-4261
KR_7753237232,960.409,16.01,58982,63178,-4196
KR_7753237232,1020.437,17.01,61562,67496,-5934
KR_7753237232,1080.465,18.01,65667,70154,-4487
KR_7753237232,1140.486,19.01,69613,72513,-2900
KR_7753237232,1200.512,20.01,73931,75329,-1398
KR_7753237232,1260.535,21.01,76327,78317,-1990
KR_7753237232,1320.564,22.01,80086,81203,-1117
KR_7753237232,1380.594,23.01,83340,84086,-746
KR_7753237232,1440.612,24.01,85932,86844,-912
KR_7753237232,1500.643,25.01,92690,90793,1897
KR_7753237232,1560.653,26.01,95197,93128,2069
KR_7753237232,1606.459,26.77,98419,95541,2878
KR_7771853421,0.0,0.0,7000,7000,0
KR_7771853421,60.028,1.0,7021,7015,6
KR_7771853421,120.057,2.0,10119,9181,938
KR_7771853421,180.113,3.0,13572,11384,2188
KR_7771853421,240.134,4.0,16343,14000,2343
KR_7771853421,300.158,5.0,19806,16985,2821
KR_7771853421,360.178,6.0,23478,20956,2522
KR_7771853421,420.211,7.0,28097,23074,5023
KR_7771853421,480.243,8.0,31324,26646,4678
KR_7771853421,506.8,8.45,32748,28257,4491
KR_7740177282,0.0,0.0,7000,7000,0
KR_7740177282,60.011,1.0,7437,7683,-246
KR_7740177282,120.043,2.0,11382,11708,-326
KR_7740177282,180.124,3.0,14941,15149,-208
KR_7740177282,240.149,4.0,19887,19117,770
KR_7740177282,300.173,5.0,23363,23545,-182
KR_7740177282,360.197,6.0,26673,27710,-1037
KR_7740177282,420.219,7.0,29961,30635,-674
KR_7740177282,480.219,8.0,33076,34476,-1400
KR_7740177282,540.238,9.0,36656,38627,-1971
KR_7740177282,600.257,10.0,39491,43043,-3552
KR_7740177282,660.288,11.0,42534,46491,-3957
KR_7740177282,720.3,12.0,46355,49484,-3129
KR_7740177282,780.319,13.01,48682,54634,-5952
KR_7740177282,840.35,14.01,52364,57630,-5266
KR_7740177282,898.712,14.98,54819,62608,-7789
KR_7778905072,0.0,0.0,7000,7000,0
KR_7778905072,60.0,1.0,7040,7015,25
KR_7778905072,120.024,2.0,10648,9483,1165
KR_7778905072,180.074,3.0,13601,12227,1374
KR_7778905072,240.094,4.0,17928,15580,2348
KR_7778905072,300.118,5.0,20599,19534,1065
KR_7778905072,360.14,6.0,25532,21930,3602
KR_7778905072,420.159,7.0,27905,25023,2882
KR_7778905072,480.178,8.0,31394,29785,1609
KR_7778905072,540.187,9.0,35916,32357,3559
KR_7778905072,546.065,9.1,36081,32522,3559
KR_7779767149,0.0,0.0,7000,7000,0
KR_7779767149,60.015,1.0,7015,7015,0
KR_7779767149,120.021,2.0,10501,10456,45
KR_7779767149,180.047,3.0,14053,14590,-537
KR_7779767149,240.079,4.0,17465,18140,-675
KR_7779767149,300.128,5.0,20496,21114,-618
KR_7779767149,360.131,6.0,24745,26360,-1615
KR_7779767149,420.157,7.0,27722,29199,-1477
KR_7779767149,480.174,8.0,31805,32251,-446
KR_7779767149,540.203,9.0,34051,35397,-1346
KR_7779767149,600.208,10.0,38126,38791,-665
KR_7779767149,660.239,11.0,42141,41540,601
KR_7779767149,720.263,12.0,45031,46708,-1677
KR_7779767149,780.279,13.0,50434,48955,1479
KR_7779767149,840.293,14.0,52762,52286,476
KR_7779767149,900.303,15.01,56742,54547,2195
KR_7779767149,942.92,15.72,59508,56135,3373
KR_7740351256,0.0,0.0,7000,7000,0
KR_7740351256,60.016,1.0,7015,7025,-10
KR_7740351256,120.025,2.0,10690,11599,-909
KR_7740351256,180.04,3.0,15071,14805,266
KR_7740351256,240.043,4.0,18412,18658,-246
KR_7740351256,300.064,5.0,22115,21935,180
KR_7740351256,360.08,6.0,25199,26385,-1186
KR_7740351256,420.152,7.0,29020,30754,-1734
KR_7740351256,480.172,8.0,32025,33607,-1582
KR_7740351256,540.197,9.0,35900,38546,-2646
KR_7740351256,600.221,10.0,38448,42080,-3632
KR_7740351256,660.225,11.0,41778,45521,-3743
KR_7740351256,720.237,12.0,44462,48196,-3734
KR_7740351256,780.246,13.0,49488,51800,-2312
KR_7740351256,840.256,14.0,52241,55202,-2961
KR_7740351256,900.28,15.0,55785,57840,-2055
KR_7740351256,960.295,16.0,59841,61721,-1880
KR_7740351256,1020.327,17.01,62104,64024,-1920
KR_7740351256,1080.337,18.01,65427,67938,-2511
KR_7740351256,1140.366,19.01,68751,70377,-1626
KR_7740351256,1170.858,19.51,71476,71327,149
KR_7734431106,0.0,0.0,7000,7000,0
KR_7734431106,60.003,1.0,7597,7015,582
KR_7734431106,120.026,2.0,10848,10787,61
KR_7734431106,180.087,3.0,13691,13173,518
KR_7734431106,240.107,4.0,16257,15842,415
KR_7734431106,300.12,5.0,19560,19589,-29
KR_7734431106,360.142,6.0,23508,22579,929
KR_7734431106,420.15,7.0,25695,25840,-145
KR_7734431106,480.174,8.0,29939,29168,771
KR_7734431106,540.176,9.0,35178,32181,2997
KR_7734431106,600.196,10.0,38059,36698,1361
KR_7734431106,660.223,11.0,42552,38635,3917
KR_7734431106,720.236,12.0,45683,42529,3154
KR_7734431106,780.239,13.0,48811,45279,3532
KR_7734431106,840.269,14.0,54255,47509,6746
KR_7734431106,843.876,14.06,54360,47614,6746
KR_7706403984,0.0,0.0,7000,7000,0
KR_7706403984,60.032,1.0,7015,7015,0
KR_7706403984,120.039,2.0,9397,12358,-2961
KR_7706403984,180.104,3.0,13146,15470,-2324
KR_7706403984,240.131,4.0,15658,18921,-3263
KR_7706403984,300.143,5.0,19243,22235,-2992
KR_7706403984,360.161,6.0,22514,24649,-2135
KR_7706403984,420.162,7.0,25223,29118,-3895
KR_7706403984,480.181,8.0,27926,32562,-4636
KR_7706403984,540.182,9.0,32708,35086,-2378
KR_7706403984,600.213,10.0,35468,37954,-2486
KR_7706403984,660.216,11.0,38573,43484,-4911
KR_7706403984,720.246,12.0,40946,47559,-6613
KR_7706403984,780.269,13.0,45175,50160,-4985
KR_7706403984,840.291,14.0,47887,52683,-4796
KR_7706403984,900.297,15.0,50862,57390,-6528
KR_7706403984,960.327,16.01,54149,60109,-5960
KR_7706403984,1016.631,16.94,56489,64705,-8216
KR_7778609686,0.0,0.0,7000,7000,0
KR_7778609686,60.02,1.0,7418,8225,-807
KR_7778609686,120.042,2.0,10429,10681,-252
KR_7778609686,180.137,3.0,13995,13914,81
KR_7778609686,240.164,4.0,18078,17423,655
KR_7778609686,300.187,5.0,20961,20865,96
KR_7778609686,360.209,6.0,23694,24234,-540
KR_7778609686,420.215,7.0,27547,27305,242
KR_7778609686,480.239,8.0,29762,30430,-668
KR_7778609686,540.259,9.0,32739,35016,-2277
KR_7778609686,600.262,10.0,37874,37705,169
KR_7778609686,660.289,11.0,41037,40502,535
KR_7778609686,720.301,12.01,43557,43069,488
KR_7778609686,755.077,12.58,46355,44616,1739
KR_7779267305,0.0,0.0,7000,7000,0
KR_7779267305,60.023,1.0,7015,7015,0
KR_7779267305,120.024,2.0,10432,9896,536
KR_7779267305,180.029,3.0,13637,13204,433
KR_7779267305,240.042,4.0,17867,17096,771
KR_7779267305,300.131,5.0,20988,19833,1155
KR_7779267305,360.132,6.0,25766,22940,2826
KR_7779267305,420.154,7.0,28322,26795,1527
KR_7779267305,480.175,8.0,32126,29962,2164
KR_7779267305,540.206,9.0,34785,32726,2059
KR_7779267305,600.215,10.0,38680,35745,2935
KR_7779267305,660.248,11.0,41593,38871,2722
KR_7779267305,720.264,12.0,45166,42111,3055
KR_7779267305,780.266,13.0,47995,45546,2449
KR_7779267305,840.276,14.0,50574,48003,2571
KR_7779267305,900.282,15.0,54455,50963,3492
KR_7779267305,923.734,15.4,56378,51668,4710
KR_7741932244,0.0,0.0,7000,7000,0
KR_7741932244,60.026,1.0,7015,7015,0
KR_7741932244,120.059,2.0,9168,9682,-514
KR_7741932244,180.125,3.0,11586,12780,-1194
KR_7741932244,240.142,4.0,13939,15294,-1355
KR_7741932244,300.157,5.0,16701,17814,-1113
KR_7741932244,360.181,6.0,19167,20419,-1252
KR_7741932244,420.182,7.0,22873,23808,-935
KR_7741932244,480.186,8.0,26533,26809,-276
KR_7741932244,540.205,9.0,28763,30408,-1645
KR_7741932244,600.213,10.0,31522,32945,-1423
KR_7741932244,660.216,11.0,36362,36424,-62
KR_7741932244,720.22,12.0,38729,39269,-540
KR_7741932244,780.236,13.0,41571,42849,-1278
KR_7741932244,840.267,14.0,44800,45597,-797
KR_7741932244,900.27,15.0,46899,49765,-2866
KR_7741932244,960.275,16.0,49559,52739,-3180
KR_7741932244,1020.293,17.0,53614,55680,-2066
KR_7741932244,1080.312,18.01,56158,58247,-2089
KR_7741932244,1140.344,19.01,58506,61467,-2961
KR_7741932244,1200.377,20.01,61320,64236,-2916
KR_7741932244,1260.389,21.01,63592,69204,-5612
KR_7741932244,1297.042,21.62,66407,71393,-4986
KR_7765887840,0.0,0.0,7000,7000,0
KR_7765887840,60.003,1.0,7015,7015,0
KR_7765887840,120.028,2.0,10141,9352,789
KR_7765887840,180.118,3.0,14100,12321,1779
KR_7765887840,240.141,4.0,16745,15044,1701
KR_7765887840,300.156,5.0,21314,18282,3032
KR_7765887840,360.183,6.0,25831,20593,5238
KR_7765887840,420.207,7.0,29016,24553,4463
KR_7765887840,480.208,8.0,32528,27996,4532
KR_7765887840,540.212,9.0,35032,30834,4198
KR_7765887840,600.242,10.0,38792,33476,5316
KR_7765887840,660.26,11.0,42046,36952,5094
KR_7765887840,696.242,11.6,44976,38032,6944
KR_7644736056,0.0,0.0,7000,7000,0
KR_7644736056,60.018,1.0,7616,7015,601
KR_7644736056,120.032,2.0,10317,10565,-248
KR_7644736056,180.113,3.0,13617,14043,-426
KR_7644736056,240.119,4.0,17357,17671,-314
KR_7644736056,300.135,5.0,20578,20804,-226
KR_7644736056,360.163,6.0,23361,23867,-506
KR_7644736056,420.173,7.0,27447,27736,-289
KR_7644736056,480.179,8.0,30419,30661,-242
KR_7644736056,540.181,9.0,33943,33323,620
KR_7644736056,600.214,10.0,37311,36432,879
KR_7644736056,660.231,11.0,39645,41546,-1901
KR_7644736056,720.264,12.0,43333,44053,-720
KR_7644736056,780.289,13.0,46215,46773,-558
KR_7644736056,840.315,14.01,48622,51740,-3118
KR_7644736056,900.345,15.01,51613,54397,-2784
KR_7644736056,960.377,16.01,54806,57638,-2832
KR_7644736056,1020.387,17.01,57874,60559,-2685
KR_7644736056,1080.416,18.01,62106,62961,-855
KR_7644736056,1140.433,19.01,64679,66446,-1767
KR_7644736056,1200.444,20.01,67463,70334,-2871
KR_7644736056,1260.466,21.01,71992,72502,-510
KR_7644736056,1320.475,22.01,74685,76758,-2073
KR_7644736056,1380.476,23.01,78048,79504,-1456
KR_7644736056,1440.486,24.01,81131,82477,-1346
KR_7644736056,1500.496,25.01,84157,85269,-1112
KR_7644736056,1551.015,25.85,86837,88391,-1554
KR_7673878067,0.0,0.0,7000,7000,0
KR_7673878067,60.006,1.0,7401,7365,36
KR_7673878067,120.028,2.0,11306,11078,228
KR_7673878067,180.109,3.0,13595,14250,-655
KR_7673878067,240.129,4.0,16378,17866,-1488
KR_7673878067,300.134,5.0,19475,21298,-1823
KR_7673878067,360.153,6.0,22975,24705,-1730
KR_7673878067,420.162,7.0,28419,27480,939
KR_7673878067,480.183,8.0,30568,31522,-954
KR_7673878067,540.204,9.0,33642,34491,-849
KR_7673878067,600.221,10.0,37740,37466,274
KR_7673878067,660.23,11.0,40192,40675,-483
KR_7673878067,720.249,12.0,43084,45155,-2071
KR_7673878067,780.267,13.0,46555,48370,-1815
KR_7673878067,840.289,14.0,48955,50901,-1946
KR_7673878067,900.303,15.01,51646,55532,-3886
KR_7673878067,960.321,16.01,54968,58222,-3254
KR_7673878067,1020.341,17.01,58221,62495,-4274
KR_7673878067,1080.359,18.01,61396,64960,-3564
KR_7673878067,1140.374,19.01,64189,68649,-4460
KR_7673878067,1198.763,19.98,66442,72288,-5846
KR_7772087561,0.0,0.0,7000,7000,0
KR_7772087561,60.03,1.0,7025,7677,-652
KR_7772087561,120.041,2.0,10151,10550,-399
KR_7772087561,180.128,3.0,13261,13616,-355
KR_7772087561,240.157,4.0,17181,16563,618
KR_7772087561,300.187,5.0,19695,20990,-1295
KR_7772087561,360.214,6.0,22011,24775,-2764
KR_7772087561,420.237,7.0,26332,28132,-1800
KR_7772087561,480.242,8.0,28758,31619,-2861
KR_7772087561,540.258,9.0,31902,36268,-4366
KR_7772087561,600.27,10.0,34632,38824,-4192
KR_7772087561,660.293,11.0,38356,42655,-4299
KR_7772087561,720.326,12.01,41314,45784,-4470
KR_7772087561,780.358,13.01,43981,48417,-4436
KR_7772087561,840.379,14.01,46414,51635,-5221
KR_7772087561,900.389,15.01,50462,55011,-4549
KR_7772087561,960.414,16.01,52773,57291,-4518
KR_7772087561,1020.429,17.01,55352,60418,-5066
KR_7772087561,1080.433,18.01,58949,63617,-4668
KR_7772087561,1140.444,19.01,61521,67005,-5484
KR_7772087561,1200.46,20.01,65836,69159,-3323
KR_7772087561,1260.482,21.01,68479,73810,-5331
KR_7772087561,1320.513,22.01,73617,77184,-3567
KR_7772087561,1380.523,23.01,77072,79740,-2668
KR_7772087561,1440.529,24.01,80663,83868,-3205
KR_7772087561,1493.362,24.89,84983,85567,-584
KR_7765995521,0.0,0.0,7000,7000,0
KR_7765995521,60.008,1.0,7015,7015,0
KR_7765995521,120.036,2.0,9423,9353,70
KR_7765995521,180.095,3.0,13021,14683,-1662
KR_7765995521,240.109,4.0,15525,16971,-1446
KR_7765995521,300.133,5.0,18030,19581,-1551
KR_7765995521,360.162,6.0,22283,24434,-2151
KR_7765995521,420.184,7.0,25130,27284,-2154
KR_7765995521,480.201,8.0,28459,31300,-2841
KR_7765995521,540.231,9.0,31914,34601,-2687
KR_7765995521,600.25,10.0,35881,37448,-1567
KR_7765995521,660.255,11.0,38791,40846,-2055
KR_7765995521,720.27,12.0,42350,44539,-2189
KR_7765995521,780.297,13.0,44492,50117,-5625
KR_7765995521,840.301,14.01,48472,53956,-5484
KR_7765995521,900.322,15.01,51118,56349,-5231
KR_7765995521,960.335,16.01,54947,58903,-3956
KR_7765995521,1020.36,17.01,59755,62449,-2694
KR_7765995521,1080.374,18.01,61899,65157,-3258
KR_7765995521,1140.383,19.01,65275,68432,-3157
KR_7765995521,1172.248,19.54,66833,70163,-3330
KR_7769127262,0.0,0.0,7000,7000,0
KR_7769127262,60.006,1.0,7025,7015,10
KR_7769127262,120.024,2.0,10391,9929,462
KR_7769127262,180.108,3.0,13568,13561,7
KR_7769127262,240.131,4.0,16717,17452,-735
KR_7769127262,300.163,5.0,19826,20236,-410
KR_7769127262,360.185,6.0,23441,23400,41
KR_7769127262,420.21,7.0,27550,25744,1806
KR_7769127262,480.238,8.0,31270,29975,1295
KR_7769127262,540.269,9.0,34522,33584,938
KR_7769127262,600.292,10.0,37185,36325,860
KR_7769127262,660.303,11.01,40039,39011,1028
KR_7769127262,720.326,12.01,42679,41883,796
KR_7769127262,780.343,13.01,47085,44495,2590
KR_7769127262,840.368,14.01,50228,47776,2452
KR_7769127262,900.391,15.01,52637,51398,1239
KR_7769127262,960.412,16.01,55187,53896,1291
KR_7769127262,992.881,16.55,57771,55408,2363
KR_7756685700,0.0,0.0,7000,7000,0
KR_7756685700,60.01,1.0,7015,7015,0
KR_7756685700,120.038,2.0,9971,9630,341
KR_7756685700,180.095,3.0,13355,12752,603
KR_7756685700,240.116,4.0,15768,15951,-183
KR_7756685700,300.142,5.0,19280,19391,-111
KR_7756685700,360.164,6.0,22623,21868,755
KR_7756685700,420.191,7.0,25860,26313,-453
KR_7756685700,480.211,8.0,28456,28833,-377
KR_7756685700,540.237,9.0,32019,31236,783
KR_7756685700,600.267,10.0,35555,34679,876
KR_7756685700,660.273,11.0,39553,37233,2320
KR_7756685700,720.295,12.0,42411,40882,1529
KR_7756685700,780.325,13.01,45780,43240,2540
KR_7756685700,840.347,14.01,49170,46495,2675
KR_7756685700,900.36,15.01,52065,48737,3328
KR_7756685700,960.38,16.01,56345,52550,3795
KR_7756685700,1020.393,17.01,59338,55072,4266
KR_7756685700,1080.417,18.01,62299,57373,4926
KR_7756685700,1140.43,19.01,67645,60530,7115
KR_7756685700,1200.458,20.01,70077,64347,5730
KR_7756685700,1260.474,21.01,72498,66895,5603
KR_7756685700,1320.496,22.01,76012,70077,5935
KR_7756685700,1380.511,23.01,79013,74359,4654
KR_7756685700,1440.525,24.01,82846,76735,6111
KR_7756685700,1461.334,24.36,83838,77666,6172
KR_7743812609,0.0,0.0,7000,7000,0
KR_7743812609,60.004,1.0,7015,7035,-20
KR_7743812609,120.031,2.0,10153,11007,-854
KR_7743812609,180.127,3.0,12947,13906,-959
KR_7743812609,240.159,4.0,16010,17716,-1706
KR_7743812609,300.192,5.0,19662,20598,-936
KR_7743812609,360.219,6.0,23479,25746,-2267
KR_7743812609,420.228,7.0,26381,28757,-2376
KR_7743812609,480.252,8.0,30372,32738,-2366
KR_7743812609,540.267,9.0,33612,36753,-3141
KR_7743812609,600.285,10.0,37566,40643,-3077
KR_7743812609,660.291,11.0,40158,43389,-3231
KR_7743812609,720.296,12.0,43347,46345,-2998
KR_7743812609,780.301,13.01,47062,52030,-4968
KR_7743812609,840.32,14.01,50444,54953,-4509
KR_7743812609,900.332,15.01,54178,60324,-6146
KR_7743812609,960.392,16.01,56564,64090,-7526
KR_7712804771,0.0,0.0,7000,7000,0
KR_7712804771,60.026,1.0,7015,7015,0
KR_7712804771,120.053,2.0,10173,9254,919
KR_7712804771,180.119,3.0,13319,12004,1315
KR_7712804771,240.144,4.0,16166,15830,336
KR_7712804771,300.15,5.0,19898,18878,1020
KR_7712804771,360.176,6.0,23399,22134,1265
KR_7712804771,420.185,7.0,26658,25832,826
KR_7712804771,480.21,8.0,29117,28539,578
KR_7712804771,540.232,9.0,32199,32890,-691
KR_7712804771,600.259,10.0,35845,35273,572
KR_7712804771,660.273,11.0,39043,38648,395
KR_7712804771,720.294,12.0,41932,41465,467
KR_7712804771,780.312,13.01,46044,44134,1910
KR_7712804771,840.328,14.01,49525,46563,2962
KR_7712804771,900.345,15.01,53620,49336,4284
KR_7712804771,960.366,16.01,58590,51924,6666
KR_7712804771,998.042,16.63,60592,53384,7208
KR_7775188221,0.0,0.0,7000,7000,0
KR_7775188221,60.016,1.0,7015,7051,-36
KR_7775188221,120.04,2.0,9676,10417,-741
KR_7775188221,180.109,3.0,13088,14105,-1017
KR_7775188221,240.137,4.0,15938,19388,-3450
KR_7775188221,300.152,5.0,20676,22286,-1610
KR_7775188221,360.171,6.0,23036,26111,-3075
KR_7775188221,420.184,7.0,26683,29618,-2935
KR_7775188221,480.204,8.0,29335,33052,-3717
KR_7775188221,540.208,9.0,32983,37258,-4275
KR_7775188221,600.209,10.0,36352,41457,-5105
KR_7775188221,660.232,11.0,40394,44549,-4155
KR_7775188221,720.253,12.0,43031,49296,-6265
KR_7775188221,758.497,12.64,44519,52563,-8044
KR_7769785858,0.0,0.0,7000,7000,0
KR_7769785858,60.01,1.0,7015,7015,0
KR_7769785858,120.018,2.0,9354,9390,-36
KR_7769785858,180.04,3.0,11877,11880,-3
KR_7769785858,240.054,4.0,14572,15664,-1092
KR_7769785858,300.069,5.0,19276,19477,-201
KR_7769785858,360.08,6.0,22246,21861,385
KR_7769785858,420.083,7.0,24959,24878,81
KR_7769785858,480.103,8.0,28626,27975,651
KR_7769785858,540.106,9.0,31722,30825,897
KR_7769785858,600.124,10.0,35148,34241,907
KR_7769785858,660.134,11.0,39625,37682,1943
KR_7769785858,720.152,12.0,43280,40450,2830
KR_7769785858,780.155,13.0,45637,42974,2663
KR_7769785858,840.182,14.0,48053,46772,1281
KR_7769785858,900.264,15.0,51922,49926,1996
KR_7769785858,960.281,16.0,54987,52169,2818
KR_7769785858,1020.29,17.0,58251,55273,2978
KR_7769785858,1080.316,18.01,60903,58171,2732
KR_7769785858,1140.319,19.01,64349,61914,2435
KR_7769785858,1200.336,20.01,67857,65497,2360
KR_7769785858,1260.344,21.01,71960,68155,3805
KR_7769785858,1282.165,21.37,74348,68815,5533
KR_7775355294,0.0,0.0,7000,7000,0
KR_7775355294,60.031,1.0,7015,7015,0
KR_7775355294,120.055,2.0,9256,9416,-160
KR_7775355294,180.1,3.0,12144,13386,-1242
KR_7775355294,240.119,4.0,16647,16891,-244
KR_7775355294,300.162,5.0,19619,21214,-1595
KR_7775355294,360.186,6.0,24027,23714,313
KR_7775355294,420.196,7.0,27686,28700,-1014
KR_7775355294,480.213,8.0,31073,31258,-185
KR_7775355294,540.235,9.0,33922,34009,-87
KR_7775355294,600.254,10.0,38603,37524,1079
KR_7775355294,660.277,11.0,41128,41383,-255
KR_7775355294,720.293,12.0,44922,44594,328
KR_7775355294,780.293,13.0,48705,47382,1323
KR_7775355294,840.31,14.01,52086,50614,1472
KR_7775355294,900.328,15.01,54778,52927,1851
KR_7775355294,960.355,16.01,58181,56935,1246
KR_7775355294,1020.361,17.01,61634,60060,1574
KR_7775355294,1080.382,18.01,65191,63712,1479
KR_7775355294,1140.394,19.01,68211,66430,1781
KR_7775355294,1200.41,20.01,71080,70206,874
KR_7775355294,1260.427,21.01,74451,73341,1110
KR_7775355294,1320.45,22.01,77859,76731,1128
KR_7775355294,1380.466,23.01,80283,79788,495
KR_7775355294,1440.487,24.01,84748,82159,2589
KR_7775355294,1462.063,24.37,87124,82804,4320
KR_7769190940,0.0,0.0,7000,7000,0
KR_7769190940,60.024,1.0,7015,7015,0
KR_7769190940,120.045,2.0,10076,9196,880
KR_7769190940,180.113,3.0,13094,12710,384
KR_7769190940,240.131,4.0,15949,15467,482
KR_7769190940,300.137,5.0,19449,18399,1050
KR_7769190940,360.155,6.0,22596,22290,306
KR_7769190940,420.156,7.0,26174,27490,-1316
KR_7769190940,480.175,8.0,30576,30738,-162
KR_7769190940,540.195,9.0,33902,34571,-669
KR_7769190940,600.213,10.0,37770,37851,-81
KR_7769190940,660.214,11.0,40825,40332,493
KR_7769190940,720.233,12.0,43002,44558,-1556
KR_7769190940,780.264,13.0,46653,46977,-324
KR_7769190940,840.282,14.0,49606,50946,-1340
KR_7769190940,900.308,15.01,53283,53192,91
KR_7769190940,960.327,16.01,55607,57195,-1588
KR_7769190940,1020.339,17.01,58168,59860,-1692
KR_7769190940,1080.363,18.01,61629,62087,-458
KR_7769190940,1140.395,19.01,66623,65007,1616
KR_7769190940,1200.413,20.01,68650,68158,492
KR_7769190940,1260.435,21.01,72248,70566,1682
KR_7769190940,1283.381,21.39,74785,71256,3529
KR_7778008044,0.0,0.0,7000,7000,0
KR_7778008044,60.001,1.0,7491,7015,476
KR_7778008044,120.003,2.0,11290,11461,-171
KR_7778008044,180.029,3.0,13805,14390,-585
KR_7778008044,240.037,4.0,17885,16700,1185
KR_7778008044,300.043,5.0,21930,23113,-1183
KR_7778008044,360.047,6.0,24691,25492,-801
KR_7778008044,420.057,7.0,28104,28681,-577
KR_7778008044,480.069,8.0,31624,32698,-1074
KR_7778008044,540.162,9.0,36441,35552,889
KR_7778008044,600.168,10.0,39255,38768,487
KR_7778008044,660.193,11.0,41617,43042,-1425
KR_7778008044,720.208,12.0,44443,46818,-2375
KR_7778008044,780.224,13.0,47925,48890,-965
KR_7778008044,840.234,14.0,51278,52387,-1109
KR_7778008044,900.263,15.0,54088,55414,-1326
KR_7778008044,960.264,16.0,57255,59552,-2297
KR_7778008044,1020.276,17.0,60723,61795,-1072
KR_7778008044,1080.29,18.0,63181,65243,-2062
KR_7778008044,1140.29,19.0,67277,68523,-1246
KR_7778008044,1200.292,20.0,70060,71524,-1464
KR_7778008044,1260.3,21.0,72353,74570,-2217
KR_7778008044,1320.308,22.01,75945,77639,-1694
KR_7778008044,1380.32,23.01,78896,80942,-2046
KR_7778008044,1440.35,24.01,82253,83690,-1437
KR_7778008044,1500.352,25.01,85327,87015,-1688
KR_7778008044,1515.688,25.26,85792,88152,-2360
KR_7747249818,0.0,0.0,7000,7000,0
KR_7747249818,60.001,1.0,7015,7015,0
KR_7747249818,120.019,2.0,9846,10066,-220
KR_7747249818,180.077,3.0,13755,13891,-136
KR_7747249818,240.098,4.0,16124,16446,-322
KR_7747249818,300.132,5.0,20129,20682,-553
KR_7747249818,360.155,6.0,23260,23469,-209
KR_7747249818,420.178,7.0,25917,25840,77
KR_7747249818,480.203,8.0,30015,29743,272
KR_7747249818,540.221,9.0,33885,32295,1590
KR_7747249818,600.248,10.0,37481,35702,1779
KR_7747249818,660.263,11.0,41201,39640,1561
KR_7747249818,720.271,12.0,46093,42043,4050
KR_7747249818,780.299,13.0,48770,46024,2746
KR_7747249818,840.321,14.01,52149,49390,2759
KR_7747249818,900.34,15.01,54866,53325,1541
KR_7747249818,960.363,16.01,58227,55583,2644
KR_7747249818,1020.364,17.01,63393,58000,5393
KR_7747249818,1030.117,17.17,63728,58677,5051
KR_7778568524,0.0,0.0,7000,7000,0
KR_7778568524,60.008,1.0,8103,7891,212
KR_7778568524,120.041,2.0,11594,10319,1275
KR_7778568524,180.076,3.0,14244,13597,647
KR_7778568524,240.095,4.0,17827,17454,373
KR_7778568524,300.157,5.0,20696,20819,-123
KR_7778568524,360.179,6.0,25084,23616,1468
KR_7778568524,420.207,7.0,27829,28665,-836
KR_7778568524,480.235,8.0,31057,32078,-1021
KR_7778568524,540.259,9.0,34724,35481,-757
KR_7778568524,600.259,10.0,37936,38109,-173
KR_7778568524,660.29,11.0,40332,42935,-2603
KR_7778568524,720.297,12.0,44190,46195,-2005
KR_7778568524,780.312,13.01,46552,48919,-2367
KR_7778568524,840.319,14.01,49674,52568,-2894
KR_7778568524,900.342,15.01,52770,56620,-3850
KR_7778568524,960.373,16.01,55163,60570,-5407
KR_7778568524,963.78,16.06,55268,60685,-5417
KR_7777808797,0.0,0.0,7000,7000,0
KR_7777808797,60.031,1.0,7265,7745,-480
KR_7777808797,120.043,2.0,10412,10847,-435
KR_7777808797,180.063,3.0,14272,13821,451
KR_7777808797,240.091,4.0,18417,17528,889
KR_7777808797,300.173,5.0,20921,20991,-70
KR_7777808797,360.18,6.0,25267,25223,44
KR_7777808797,420.193,7.0,28810,27565,1245
KR_7777808797,480.217,8.0,32002,31554,448
KR_7777808797,540.22,9.0,36302,35030,1272
KR_7777808797,600.226,10.0,38553,38243,310
KR_7777808797,660.255,11.0,42324,41675,649
KR_7777808797,720.286,12.0,45573,44447,1126
KR_7777808797,780.297,13.0,48024,48021,3
KR_7777808797,840.33,14.01,50464,52534,-2070
KR_7777808797,900.336,15.01,54321,56157,-1836
KR_7777808797,960.358,16.01,57118,58652,-1534
KR_7777808797,1020.361,17.01,60020,61208,-1188
KR_7777808797,1080.37,18.01,63015,65236,-2221
KR_7777808797,1140.382,19.01,67404,67808,-404
KR_7777808797,1200.386,20.01,70427,71521,-1094
KR_7777808797,1260.411,21.01,72815,74673,-1858
KR_7777808797,1298.083,21.63,76135,76004,131
KR_7775189447,0.0,0.0,7000,7000,0
KR_7775189447,60.002,1.0,7015,7015,0
KR_7775189447,120.011,2.0,10319,10293,26
KR_7775189447,180.03,3.0,12787,12774,13
KR_7775189447,240.056,4.0,16441,16745,-304
KR_7775189447,300.118,5.0,19730,20554,-824
KR_7775189447,360.147,6.0,22665,23489,-824
KR_7775189447,420.153,7.0,25883,27253,-1370
KR_7775189447,480.176,8.0,29110,31678,-2568
KR_7775189447,540.206,9.0,32411,34778,-2367
KR_7775189447,600.22,10.0,35033,38742,-3709
KR_7775189447,660.24,11.0,39204,41911,-2707
KR_7775189447,720.271,12.0,43133,45509,-2376
KR_7775189447,780.273,13.0,47114,48745,-1631
KR_7775189447,840.295,14.0,50226,51184,-958
KR_7775189447,900.296,15.0,53226,55066,-1840
KR_7775189447,960.318,16.01,57222,58281,-1059
KR_7775189447,1020.346,17.01,60227,61874,-1647
KR_7775189447,1080.374,18.01,63229,64971,-1742
KR_7775189447,1140.4,19.01,65992,68030,-2038
KR_7775189447,1200.424,20.01,71336,70751,585
KR_7775189447,1209.108,20.15,71653,71006,647
KR_7749339077,0.0,0.0,7000,7000,0
KR_7749339077,60.032,1.0,7018,7015,3
KR_7749339077,120.05,2.0,10805,9206,1599
KR_7749339077,180.127,3.0,14013,13466,547
KR_7749339077,240.144,4.0,18010,16241,1769
KR_7749339077,300.158,5.0,21169,20655,514
KR_7749339077,360.161,6.0,24370,23731,639
KR_7749339077,420.167,7.0,26935,27551,-616
KR_7749339077,480.186,8.0,30745,29791,954
KR_7749339077,540.186,9.0,33457,32780,677
KR_7749339077,600.212,10.0,37150,36090,1060
KR_7749339077,660.229,11.0,40563,39787,776
KR_7749339077,720.246,12.0,44661,42871,1790
KR_7749339077,780.251,13.0,48104,45627,2477
KR_7749339077,840.269,14.0,51287,48872,2415
KR_7749339077,900.277,15.0,53771,51880,1891
KR_7749339077,960.294,16.0,57142,56400,742
KR_7749339077,1020.302,17.01,59904,59651,253
KR_7749339077,1080.325,18.01,64598,61773,2825
KR_7749339077,1140.329,19.01,67641,65210,2431
KR_7749339077,1200.349,20.01,70581,68248,2333
KR_7749339077,1260.349,21.01,74405,71069,3336
KR_7749339077,1320.367,22.01,76795,74024,2771
KR_7749339077,1380.4,23.01,80375,76637,3738
KR_7749339077,1440.418,24.01,82430,80479,1951
KR_7749339077,1500.446,25.01,86651,84260,2391
KR_7749339077,1560.468,26.01,89223,86704,2519
KR_7749339077,1620.49,27.01,95459,89760,5699
KR_7749339077,1635.921,27.27,96199,90225,5974
KR_7775406800,0.0,0.0,7000,7000,0
KR_7775406800,60.001,1.0,7015,7015,0
KR_7775406800,120.024,2.0,9305,9904,-599
KR_7775406800,180.082,3.0,12869,12519,350
KR_7775406800,240.093,4.0,15765,15986,-221
KR_7775406800,300.096,5.0,19221,19873,-652
KR_7775406800,360.109,6.0,23435,23178,257
KR_7775406800,420.131,7.0,26246,26885,-639
KR_7775406800,480.147,8.0,28983,29325,-342
KR_7775406800,540.152,9.0,33570,31801,1769
KR_7775406800,600.169,10.0,36817,34856,1961
KR_7775406800,660.197,11.0,40428,38832,1596
KR_7775406800,719.586,11.99,45037,40994,4043
KR_7773561882,0.0,0.0,7000,7000,0
KR_7773561882,60.011,1.0,7015,7015,0
KR_7773561882,120.026,2.0,10476,10564,-88
KR_7773561882,180.111,3.0,14673,13923,750
KR_7773561882,240.115,4.0,17512,17555,-43
KR_7773561882,300.132,5.0,20609,20037,572
KR_7773561882,360.155,6.0,23641,23888,-247
KR_7773561882,420.155,7.0,27961,26607,1354
KR_7773561882,480.18,8.0,30487,30392,95
KR_7773561882,540.186,9.0,34134,33085,1049
KR_7773561882,600.196,10.0,36719,37751,-1032
KR_7773561882,660.235,11.0,40533,39988,545
KR_7773561882,720.256,12.0,44105,43901,204
KR_7773561882,780.274,13.0,46678,47544,-866
KR_7773561882,840.282,14.0,50739,49620,1119
KR_7773561882,900.298,15.0,52953,52394,559
KR_7773561882,949.684,15.83,54739,55968,-1229
KR_7778830918,0.0,0.0,7000,7000,0
KR_7778830918,60.032,1.0,7015,7497,-482
KR_7778830918,120.041,2.0,10255,10089,166
KR_7778830918,180.063,3.0,13019,12655,364
KR_7778830918,240.082,4.0,15847,15987,-140
KR_7778830918,300.154,5.0,18651,19256,-605
KR_7778830918,360.155,6.0,24119,23205,914
KR_7778830918,420.19,7.0,27903,25761,2142
KR_7778830918,480.219,8.0,31182,29989,1193
KR_7778830918,540.225,9.0,34284,33166,1118
KR_7778830918,600.225,10.0,37938,36755,1183
KR_7778830918,660.25,11.0,40920,40554,366
KR_7778830918,720.267,12.0,44105,43870,235
KR_7778830918,780.297,13.0,48078,46690,1388
KR_7778830918,840.319,14.01,51291,49775,1516
KR_7778830918,900.348,15.01,54656,53858,798
KR_7778830918,960.358,16.01,58185,56337,1848
KR_7778830918,1020.361,17.01,60870,60896,-26
KR_7778830918,1080.38,18.01,64385,63844,541
KR_7778830918,1140.403,19.01,67450,67038,412
KR_7778830918,1200.423,20.01,70135,70179,-44
KR_7778830918,1260.424,21.01,72510,73779,-1269
KR_7778830918,1302.818,21.71,74040,77518,-3478
KR_7766921195,0.0,0.0,7000,7000,0
KR_7766921195,60.004,1.0,7015,7015,0
KR_7766921195,120.021,2.0,9447,10066,-619
KR_7766921195,180.034,3.0,13591,12849,742
KR_7766921195,240.05,4.0,17318,16776,542
KR_7766921195,300.066,5.0,20513,20261,252
KR_7766921195,360.072,6.0,24064,24751,-687
KR_7766921195,420.083,7.0,26876,27172,-296
KR_7766921195,480.086,8.0,29067,32103,-3036
KR_7766921195,540.093,9.0,32824,34524,-1700
KR_7766921195,600.11,10.0,35328,37167,-1839
KR_7766921195,660.111,11.0,39265,40520,-1255
KR_7766921195,720.141,12.0,42959,44245,-1286
KR_7766921195,780.258,13.0,46318,46873,-555
KR_7766921195,840.291,14.0,49334,50076,-742
KR_7766921195,900.324,15.01,52518,53428,-910
KR_7766921195,960.353,16.01,55945,55956,-11
KR_7766921195,1020.376,17.01,59116,58992,124
KR_7766921195,1080.392,18.01,62949,62354,595
KR_7766921195,1140.399,19.01,65616,66190,-574
KR_7766921195,1200.416,20.01,68032,69946,-1914
KR_7766921195,1260.44,21.01,70693,72493,-1800
KR_7766921195,1320.458,22.01,73234,75904,-2670
KR_7766921195,1380.466,23.01,77015,78874,-1859
KR_7766921195,1440.499,24.01,80221,82198,-1977
KR_7766921195,1500.513,25.01,83569,84792,-1223
KR_7766921195,1560.525,26.01,87579,88698,-1119
KR_7766921195,1620.558,27.01,90828,92047,-1219
KR_7766921195,1680.565,28.01,94774,94236,538
KR_7766921195,1740.592,29.01,98147,97810,337
KR_7766921195,1773.65,29.56,101428,98876,2552
KR_7773495018,0.0,0.0,7000,7000,0
KR_7773495018,60.032,1.0,7015,7015,0
KR_7773495018,120.043,2.0,9787,9877,-90
KR_7773495018,180.061,3.0,13371,12166,1205
KR_7773495018,240.091,4.0,16005,15153,852
KR_7773495018,300.173,5.0,19884,18120,1764
KR_7773495018,360.192,6.0,22275,20985,1290
KR_7773495018,420.208,7.0,25609,25123,486
KR_7773495018,480.229,8.0,28064,28507,-443
KR_7773495018,540.241,9.0,30374,31222,-848
KR_7773495018,600.261,10.0,32704,33778,-1074
KR_7773495018,660.268,11.0,36341,37792,-1451
KR_7773495018,720.275,12.0,39502,40131,-629
KR_7773495018,780.307,13.01,41907,43917,-2010
KR_7773495018,840.325,14.01,44740,47313,-2573
KR_7773495018,900.35,15.01,46821,53102,-6281
KR_7773495018,912.976,15.22,47512,53802,-6290
KR_7769966031,0.0,0.0,7000,7000,0
KR_7769966031,60.0,1.0,7955,8196,-241
KR_7769966031,120.026,2.0,10832,10525,307
KR_7769966031,180.116,3.0,14140,14222,-82
KR_7769966031,240.137,4.0,18034,18126,-92
KR_7769966031,300.162,5.0,21647,22159,-512
KR_7769966031,360.19,6.0,24357,24923,-566
KR_7769966031,420.202,7.0,27001,27537,-536
KR_7769966031,480.226,8.0,30822,31903,-1081
KR_7769966031,540.241,9.0,34261,35989,-1728
KR_7769966031,600.274,10.0,37820,39399,-1579
KR_7769966031,660.299,11.0,40289,41720,-1431
KR_7769966031,720.31,12.01,45754,45484,270
KR_7769966031,780.315,13.01,48030,48023,7
KR_7769966031,840.316,14.01,53665,51251,2414
KR_7769966031,900.333,15.01,57264,55384,1880
KR_7769966031,960.339,16.01,59315,57950,1365
KR_7769966031,995.401,16.59,63134,59000,4134
KR_7742171605,0.0,0.0,7000,7000,0
KR_7742171605,60.02,1.0,8107,7413,694
KR_7742171605,120.035,2.0,10569,10173,396
KR_7742171605,180.044,3.0,13762,14918,-1156
KR_7742171605,240.066,4.0,17795,19008,-1213
KR_7742171605,300.128,5.0,21834,22492,-658
KR_7742171605,360.131,6.0,24773,27302,-2529
KR_7742171605,420.131,7.0,28206,30517,-2311
KR_7742171605,480.157,8.0,31948,34052,-2104
KR_7742171605,540.185,9.0,35723,38744,-3021
KR_7742171605,600.215,10.0,39803,42983,-3180
KR_7742171605,660.247,11.0,42822,45463,-2641
KR_7742171605,720.269,12.0,45368,51249,-5881
KR_7742171605,780.298,13.0,48854,53481,-4627
KR_7742171605,840.323,14.01,51730,57051,-5321
KR_7742171605,845.133,14.09,51865,57643,-5778
KR_7730463897,0.0,0.0,7000,7000,0
KR_7730463897,60.007,1.0,7015,7015,0
KR_7730463897,120.008,2.0,10946,9270,1676
KR_7730463897,180.039,3.0,13439,12175,1264
KR_7730463897,240.059,4.0,16321,16589,-268
KR_7730463897,300.126,5.0,19986,19512,474
KR_7730463897,360.146,6.0,23935,22405,1530
KR_7730463897,420.177,7.0,27701,26353,1348
KR_7730463897,480.196,8.0,30380,29509,871
KR_7730463897,540.205,9.0,33887,31792,2095
KR_7730463897,600.233,10.0,36981,35851,1130
KR_7730463897,660.238,11.0,39836,38104,1732
KR_7730463897,720.27,12.0,43554,41790,1764
KR_7730463897,780.299,13.0,46311,44613,1698
KR_7730463897,840.307,14.01,49249,50014,-765
KR_7730463897,900.308,15.01,52263,52917,-654
KR_7730463897,960.323,16.01,55269,56610,-1341
KR_7730463897,1020.325,17.01,58732,58807,-75
KR_7730463897,1080.335,18.01,60859,64561,-3702
KR_7730463897,1140.357,19.01,65112,67805,-2693
KR_7730463897,1200.368,20.01,68118,70553,-2435
KR_7730463897,1229.444,20.49,69594,72731,-3137
KR_7644896899,0.0,0.0,7000,7000,0
KR_7644896899,60.01,1.0,7015,7015,0
KR_7644896899,120.03,2.0,9277,9908,-631
KR_7644896899,180.109,3.0,11802,12618,-816
KR_7644896899,240.137,4.0,16189,16847,-658
KR_7644896899,300.158,5.0,19736,21044,-1308
KR_7644896899,360.18,6.0,23834,23609,225
KR_7644896899,420.192,7.0,27385,27219,166
KR_7644896899,480.218,8.0,31051,31277,-226
KR_7644896899,540.243,9.0,33897,35101,-1204
KR_7644896899,600.264,10.0,37143,37948,-805
KR_7644896899,660.293,11.0,39686,41378,-1692
KR_7644896899,720.32,12.01,43819,44077,-258
KR_7644896899,780.341,13.01,45958,48760,-2802
KR_7644896899,840.352,14.01,49517,51965,-2448
KR_7644896899,900.37,15.01,53265,54703,-1438
KR_7644896899,960.395,16.01,55121,59897,-4776
KR_7644896899,970.582,16.18,55701,60347,-4646
KR_7758506640,0.0,0.0,7000,7000,0
KR_7758506640,60.028,1.0,7015,8031,-1016
KR_7758506640,120.047,2.0,9635,12880,-3245
KR_7758506640,180.14,3.0,14093,16741,-2648
KR_7758506640,240.17,4.0,17838,20956,-3118
KR_7758506640,300.186,5.0,21097,24722,-3625
KR_7758506640,360.205,6.0,23622,27426,-3804
KR_7758506640,420.214,7.0,27976,31381,-3405
KR_7758506640,480.24,8.0,30520,35061,-4541
KR_7758506640,540.242,9.0,33923,38855,-4932
KR_7758506640,600.269,10.0,35915,42554,-6639
KR_7758506640,648.111,10.8,38521,47159,-8638
KR_7740247492,0.0,0.0,7000,7000,0
KR_7740247492,60.027,1.0,7487,7015,472
KR_7740247492,120.051,2.0,11885,11016,869
KR_7740247492,180.127,3.0,15104,14560,544
KR_7740247492,240.135,4.0,18897,19234,-337
KR_7740247492,300.147,5.0,21549,21927,-378
KR_7740247492,360.168,6.0,25128,25736,-608
KR_7740247492,420.192,7.0,28495,28630,-135
KR_7740247492,480.209,8.0,31203,31332,-129
KR_7740247492,540.219,9.0,34593,35971,-1378
KR_7740247492,600.228,10.0,37747,40105,-2358
KR_7740247492,660.246,11.0,40879,42564,-1685
KR_7740247492,720.246,12.0,43180,47754,-4574
KR_7740247492,780.274,13.0,46998,51581,-4583
KR_7740247492,792.998,13.22,47373,52196,-4823
KR_7724198737,0.0,0.0,7000,7000,0
KR_7724198737,60.015,1.0,8498,7865,633
KR_7724198737,120.047,2.0,12459,11745,714
KR_7724198737,180.11,3.0,15972,15533,439
KR_7724198737,240.131,4.0,19884,19714,170
KR_7724198737,300.145,5.0,23991,23722,269
KR_7724198737,360.165,6.0,28766,26669,2097
KR_7724198737,420.166,7.0,32125,29900,2225
KR_7724198737,480.166,8.0,35278,33912,1366
KR_7724198737,540.185,9.0,38926,36724,2202
KR_7724198737,600.213,10.0,42385,40308,2077
KR_7724198737,660.22,11.0,46596,43758,2838
KR_7724198737,720.222,12.0,49963,47119,2844
KR_7724198737,780.243,13.0,52998,50632,2366
KR_7724198737,840.272,14.0,55964,54529,1435
KR_7724198737,900.299,15.0,58743,57052,1691
KR_7724198737,960.325,16.01,61839,60799,1040
KR_7724198737,1020.33,17.01,64577,64367,210
KR_7724198737,1080.351,18.01,67697,66576,1121
KR_7724198737,1140.353,19.01,73013,69770,3243
KR_7724198737,1200.354,20.01,76183,72823,3360
KR_7724198737,1260.385,21.01,79327,75391,3936
KR_7724198737,1320.411,22.01,81443,80011,1432
KR_7724198737,1380.439,23.01,85322,82945,2377
KR_7724198737,1440.45,24.01,88303,86286,2017
KR_7724198737,1480.19,24.67,89871,88545,1326
KR_7767191737,0.0,0.0,7000,7000,0
KR_7767191737,60.03,1.0,7015,7015,0
KR_7767191737,120.047,2.0,9896,9687,209
KR_7767191737,180.117,3.0,12414,12190,224
KR_7767191737,240.132,4.0,15933,16765,-832
KR_7767191737,300.139,5.0,18403,19255,-852
KR_7767191737,360.155,6.0,22644,23474,-830
KR_7767191737,420.175,7.0,26025,26300,-275
KR_7767191737,480.197,8.0,28891,30207,-1316
KR_7767191737,540.211,9.0,31946,33003,-1057
KR_7767191737,600.241,10.0,34952,36498,-1546
KR_7767191737,660.273,11.0,37816,39706,-1890
KR_7767191737,720.279,12.0,41814,42312,-498
KR_7767191737,780.285,13.0,46408,45455,953
KR_7767191737,840.307,14.01,48686,48282,404
KR_7767191737,900.317,15.01,53207,51742,1465
KR_7767191737,960.343,16.01,56950,54667,2283
KR_7767191737,1020.356,17.01,59192,58690,502
KR_7767191737,1080.361,18.01,62265,61610,655
KR_7767191737,1122.829,18.71,67037,62991,4046
KR_7768873564,0.0,0.0,7000,7000,0
KR_7768873564,60.004,1.0,7015,7015,0
KR_7768873564,120.014,2.0,10707,9605,1102
KR_7768873564,180.037,3.0,13586,13052,534
KR_7768873564,240.071,4.0,16808,16698,110
KR_7768873564,300.132,5.0,21393,20018,1375
KR_7768873564,360.166,6.0,23891,22752,1139
KR_7768873564,420.191,7.0,27411,26738,673
KR_7768873564,480.219,8.0,30079,29504,575
KR_7768873564,540.248,9.0,33092,32665,427
KR_7768873564,600.274,10.0,36067,35414,653
KR_7768873564,660.293,11.0,39320,38261,1059
KR_7768873564,720.311,12.01,41926,41533,393
KR_7768873564,780.319,13.01,45664,44568,1096
KR_7768873564,840.337,14.01,49658,47248,2410
KR_7768873564,900.361,15.01,52528,49672,2856
KR_7768873564,960.394,16.01,55779,53172,2607
KR_7768873564,1020.423,17.01,58537,55348,3189
KR_7768873564,1080.455,18.01,62000,60459,1541
KR_7768873564,1140.484,19.01,65739,63533,2206
KR_7768873564,1200.507,20.01,69137,66145,2992
KR_7768873564,1260.532,21.01,73319,69843,3476
KR_7768873564,1320.564,22.01,76840,72741,4099
KR_7768873564,1338.534,22.31,78252,73284,4968
KR_7778285953,0.0,0.0,7000,7000,0
KR_7778285953,60.03,1.0,7019,7015,4
KR_7778285953,120.062,2.0,9283,10210,-927
KR_7778285953,180.14,3.0,13392,13527,-135
KR_7778285953,240.173,4.0,16792,16609,183
KR_7778285953,300.189,5.0,21646,20149,1497
KR_7778285953,360.217,6.0,25572,23456,2116
KR_7778285953,420.248,7.0,28193,27665,528
KR_7778285953,480.252,8.0,33270,30591,2679
KR_7778285953,540.269,9.0,37318,34148,3170
KR_7778285953,600.297,10.0,39930,37597,2333
KR_7778285953,660.314,11.01,43352,40629,2723
KR_7778285953,720.326,12.01,46975,44010,2965
KR_7778285953,780.355,13.01,50552,47119,3433
KR_7778285953,840.376,14.01,53784,50124,3660
KR_7778285953,900.395,15.01,57906,53194,4712
KR_7778285953,960.415,16.01,60095,56283,3812
KR_7778285953,1014.082,16.9,65563,58308,7255
KR_7744024606,0.0,0.0,7000,7000,0
KR_7744024606,60.02,1.0,7015,7015,0
KR_7744024606,120.045,2.0,9740,10236,-496
KR_7744024606,180.122,3.0,12509,13052,-543
KR_7744024606,240.154,4.0,14931,15910,-979
KR_7744024606,300.159,5.0,18821,19657,-836
KR_7744024606,360.184,6.0,23418,23179,239
KR_7744024606,420.217,7.0,25931,26662,-731
KR_7744024606,480.235,8.0,29612,30314,-702
KR_7744024606,540.244,9.0,33407,33354,53
KR_7744024606,600.267,10.0,36308,35709,599
KR_7744024606,660.295,11.0,38683,40305,-1622
KR_7744024606,720.315,12.01,42445,44532,-2087
KR_7744024606,780.342,13.01,45721,47470,-1749
KR_7744024606,840.349,14.01,47990,50280,-2290
KR_7744024606,900.37,15.01,50909,53047,-2138
KR_7744024606,960.391,16.01,54524,56106,-1582
KR_7744024606,1020.415,17.01,57571,58971,-1400
KR_7744024606,1080.439,18.01,60059,63299,-3240
KR_7744024606,1140.453,19.01,63480,66444,-2964
KR_7744024606,1200.478,20.01,66482,68897,-2415
KR_7744024606,1260.504,21.01,68887,72058,-3171
KR_7744024606,1282.616,21.38,69692,72799,-3107
KR_7771334647,0.0,0.0,7000,7000,0
KR_7771334647,60.014,1.0,7363,8485,-1122
KR_7771334647,120.029,2.0,11081,10889,192
KR_7771334647,180.103,3.0,15574,14178,1396
KR_7771334647,240.127,4.0,19371,18567,804
KR_7771334647,300.139,5.0,22006,21036,970
KR_7771334647,360.149,6.0,25977,24325,1652
KR_7771334647,420.177,7.0,28979,28069,910
KR_7771334647,480.201,8.0,33160,31399,1761
KR_7771334647,540.234,9.0,36246,34957,1289
KR_7771334647,600.238,10.0,40092,38864,1228
KR_7771334647,660.244,11.0,42574,42504,70
KR_7771334647,720.246,12.0,45632,45717,-85
KR_7771334647,780.266,13.0,49187,48866,321
KR_7771334647,840.278,14.0,52217,52196,21
KR_7771334647,900.303,15.01,55884,55170,714
KR_7771334647,960.314,16.01,58386,58162,224
KR_7771334647,1020.338,17.01,63781,60630,3151
KR_7771334647,1080.347,18.01,65599,65715,-116
KR_7771334647,1140.371,19.01,69637,69109,528
KR_7771334647,1200.395,20.01,72566,71845,721
KR_7771334647,1260.397,21.01,74958,75209,-251
KR_7771334647,1320.404,22.01,78010,78846,-836
KR_7771334647,1380.406,23.01,82222,82215,7
KR_7771334647,1440.408,24.01,86063,85882,181
KR_7771334647,1463.789,24.4,87196,86587,609
KR_7628709057,0.0,0.0,7000,7000,0
KR_7628709057,60.008,1.0,7015,7015,0
KR_7628709057,120.039,2.0,9713,9806,-93
KR_7628709057,180.113,3.0,13342,12821,521
KR_7628709057,240.123,4.0,17066,16093,973
KR_7628709057,300.144,5.0,20186,19643,543
KR_7628709057,360.147,6.0,23588,22097,1491
KR_7628709057,420.178,7.0,25735,25852,-117
KR_7628709057,480.207,8.0,29028,29288,-260
KR_7628709057,540.23,9.0,32689,31543,1146
KR_7628709057,600.256,10.0,35204,35135,69
KR_7628709057,660.282,11.0,39616,37119,2497
KR_7628709057,720.284,12.0,42730,40370,2360
KR_7628709057,780.304,13.01,46701,44455,2246
KR_7628709057,840.326,14.01,50406,47896,2510
KR_7628709057,900.357,15.01,52867,50551,2316
KR_7628709057,960.37,16.01,56262,53028,3234
KR_7628709057,1020.391,17.01,59917,57243,2674
KR_7628709057,1080.392,18.01,63806,60027,3779
KR_7628709057,1140.405,19.01,66793,62907,3886
KR_7628709057,1200.429,20.01,68972,66590,2382
KR_7628709057,1260.443,21.01,71544,69140,2404
KR_7628709057,1320.45,22.01,74618,72321,2297
KR_7628709057,1380.474,23.01,78167,74306,3861
KR_7628709057,1382.378,23.04,78227,74366,3861
KR_7769224935,0.0,0.0,7000,7000,0
KR_7769224935,60.002,1.0,7015,7015,0
KR_7769224935,120.025,2.0,10120,9760,360
KR_7769224935,180.106,3.0,13888,12867,1021
KR_7769224935,240.108,4.0,17226,15194,2032
KR_7769224935,300.127,5.0,20124,18491,1633
KR_7769224935,360.146,6.0,24412,20813,3599
KR_7769224935,420.166,7.0,28233,25432,2801
KR_7769224935,480.187,8.0,31654,28063,3591
KR_7769224935,540.199,9.0,35389,31027,4362
KR_7769224935,600.22,10.0,38518,35466,3052
KR_7769224935,660.247,11.0,41190,38745,2445
KR_7769224935,720.249,12.0,44427,42126,2301
KR_7769224935,780.267,13.0,48319,44466,3853
KR_7769224935,840.293,14.0,52213,48264,3949
KR_7769224935,900.322,15.01,55003,50979,4024
KR_7769224935,960.323,16.01,58409,54493,3916
KR_7769224935,1020.326,17.01,61432,59482,1950
KR_7769224935,1080.342,18.01,65441,62071,3370
KR_7769224935,1140.353,19.01,69053,64883,4170
KR_7769224935,1200.364,20.01,71964,67942,4022
KR_7769224935,1244.087,20.73,73344,72153,1191
KR_7721768330,0.0,0.0,7000,7000,0
KR_7721768330,60.014,1.0,7015,7015,0
KR_7721768330,120.041,2.0,9695,10973,-1278
KR_7721768330,180.109,3.0,12346,14647,-2301
KR_7721768330,240.128,4.0,14769,17470,-2701
KR_7721768330,300.139,5.0,19910,21178,-1268
KR_7721768330,360.159,6.0,23065,23736,-671
KR_7721768330,420.176,7.0,26051,28945,-2894
KR_7721768330,480.196,8.0,29970,32350,-2380
KR_7721768330,540.219,9.0,33322,36413,-3091
KR_7721768330,600.247,10.0,36320,38885,-2565
KR_7721768330,660.253,11.0,39808,42583,-2775
KR_7721768330,720.282,12.0,44466,46144,-1678
KR_7721768330,780.31,13.01,48325,48696,-371
KR_7721768330,840.34,14.01,51580,52978,-1398
KR_7721768330,900.365,15.01,56021,55650,371
KR_7721768330,960.393,16.01,59113,58399,714
KR_7721768330,960.727,16.01,59128,58414,714
KR_7771881016,0.0,0.0,7000,7000,0
KR_7771881016,60.032,1.0,7015,7015,0
KR_7771881016,120.045,2.0,9647,9278,369
KR_7771881016,180.12,3.0,12261,12119,142
KR_7771881016,240.141,4.0,14871,15165,-294
KR_7771881016,300.171,5.0,17798,18304,-506
KR_7771881016,360.193,6.0,22089,21465,624
KR_7771881016,420.217,7.0,25627,24354,1273
KR_7771881016,480.218,8.0,27975,27719,256
KR_7771881016,540.242,9.0,31371,30904,467
KR_7771881016,600.274,10.0,35170,33734,1436
KR_7771881016,660.307,11.01,38752,36383,2369
KR_7771881016,720.312,12.01,40944,39773,1171
KR_7771881016,780.316,13.01,44153,42749,1404
KR_7771881016,840.327,14.01,48228,45081,3147
KR_7771881016,900.359,15.01,52088,47632,4456
KR_7771881016,960.364,16.01,54827,51823,3004
KR_7771881016,1020.395,17.01,57666,54163,3503
KR_7771881016,1080.407,18.01,60815,57406,3409
KR_7771881016,1140.421,19.01,63548,60536,3012
KR_7771881016,1200.453,20.01,66377,63265,3112
KR_7771881016,1260.472,21.01,69542,66352,3190
KR_7771881016,1320.495,22.01,72050,69511,2539
KR_7771881016,1380.524,23.01,75402,71968,3434
KR_7771881016,1425.727,23.76,79697,73771,5926
KR_7747670259,0.0,0.0,7000,7000,0
KR_7747670259,60.002,1.0,7377,7418,-41
KR_7747670259,120.032,2.0,9974,10031,-57
KR_7747670259,180.092,3.0,12902,13475,-573
KR_7747670259,240.112,4.0,16498,16108,390
KR_7747670259,300.135,5.0,19175,19424,-249
KR_7747670259,360.158,6.0,23306,23100,206
KR_7747670259,420.163,7.0,27256,25803,1453
KR_7747670259,480.195,8.0,30091,29197,894
KR_7747670259,540.223,9.0,33668,32408,1260
KR_7747670259,600.243,10.0,37764,35089,2675
KR_7747670259,660.268,11.0,41284,39521,1763
KR_7747670259,720.27,12.0,45570,41705,3865
KR_7747670259,780.279,13.0,48183,46026,2157
KR_7747670259,840.3,14.0,52589,47978,4611
KR_7747670259,884.421,14.74,55863,49316,6547
KR_7769006027,0.0,0.0,7000,7000,0
KR_7769006027,60.031,1.0,7015,7377,-362
KR_7769006027,120.031,2.0,9747,10265,-518
KR_7769006027,180.057,3.0,12565,12987,-422
KR_7769006027,240.073,4.0,15172,17008,-1836
KR_7769006027,300.138,5.0,19780,19457,323
KR_7769006027,360.158,6.0,22736,22930,-194
KR_7769006027,420.187,7.0,26439,27516,-1077
KR_7769006027,480.206,8.0,29213,30719,-1506
KR_7769006027,540.226,9.0,33135,33497,-362
KR_7769006027,600.244,10.0,36110,36790,-680
KR_7769006027,660.255,11.0,40083,39443,640
KR_7769006027,720.274,12.0,43928,41989,1939
KR_7769006027,780.295,13.0,45976,46658,-682
KR_7769006027,840.315,14.01,49042,49797,-755
KR_7769006027,900.33,15.01,52468,52294,174
KR_7769006027,960.348,16.01,56081,54461,1620
KR_7769006027,1020.364,17.01,59161,59104,57
KR_7769006027,1080.397,18.01,63242,61599,1643
KR_7769006027,1140.425,19.01,66043,64335,1708
KR_7769006027,1200.443,20.01,71123,66742,4381
KR_7769006027,1260.465,21.01,74405,69962,4443
KR_7769006027,1260.665,21.01,74420,69977,4443
KR_7775013605,0.0,0.0,7000,7000,0
KR_7775013605,60.03,1.0,7015,7015,0
KR_7775013605,120.054,2.0,9729,10267,-538
KR_7775013605,180.139,3.0,13969,14027,-58
KR_7775013605,240.17,4.0,16655,17413,-758
KR_7775013605,300.203,5.0,20813,20833,-20
KR_7775013605,360.236,6.0,23408,24081,-673
KR_7775013605,420.241,7.0,26609,26445,164
KR_7775013605,480.25,8.0,29654,29691,-37
KR_7775013605,540.252,9.0,33473,33414,59
KR_7775013605,600.264,10.0,36865,36959,-94
KR_7775013605,660.265,11.0,39552,39492,60
KR_7775013605,720.295,12.0,43208,42271,937
KR_7775013605,780.319,13.01,46637,45072,1565
KR_7775013605,840.341,14.01,49991,49092,899
KR_7775013605,900.355,15.01,52728,51973,755
KR_7775013605,960.357,16.01,55299,56524,-1225
KR_7775013605,1020.362,17.01,58258,59425,-1167
KR_7775013605,1080.377,18.01,60664,62297,-1633
KR_7775013605,1140.382,19.01,64068,65479,-1411
KR_7775013605,1200.387,20.01,66761,69270,-2509
KR_7775013605,1260.407,21.01,69835,72644,-2809
KR_7775013605,1320.43,22.01,72808,76086,-3278
KR_7775013605,1380.444,23.01,76215,80689,-4474
KR_7775013605,1440.445,24.01,79507,83491,-3984
KR_7775013605,1500.448,25.01,83143,87358,-4215
KR_7775013605,1560.465,26.01,86205,89831,-3626
KR_7775013605,1620.486,27.01,89075,93164,-4089
KR_7775013605,1656.439,27.61,90483,95990,-5507
KR_7775434141,0.0,0.0,7000,7000,0
KR_7775434141,60.012,1.0,7407,7418,-11
KR_7775434141,120.018,2.0,11096,11139,-43
KR_7775434141,180.03,3.0,14541,15311,-770
KR_7775434141,240.045,4.0,17655,17992,-337
KR_7775434141,300.058,5.0,21254,22048,-794
KR_7775434141,360.062,6.0,25076,24852,224
KR_7775434141,420.074,7.0,28785,29110,-325
KR_7775434141,480.09,8.0,32156,32057,99
KR_7775434141,540.104,9.0,36459,34581,1878
KR_7775434141,600.116,10.0,39961,38451,1510
KR_7775434141,660.128,11.0,43736,41095,2641
KR_7775434141,720.142,12.0,46258,43664,2594
KR_7775434141,780.155,13.0,48659,47593,1066
KR_7775434141,840.164,14.0,51528,53022,-1494
KR_7775434141,900.18,15.0,55062,55514,-452
KR_7775434141,960.198,16.0,57476,60431,-2955
KR_7775434141,1020.214,17.0,61764,63853,-2089
KR_7775434141,1080.224,18.0,65482,66659,-1177
KR_7775434141,1140.236,19.0,69533,70220,-687
KR_7775434141,1200.26,20.0,72919,72353,566
KR_7775434141,1217.859,20.3,75077,73512,1565
KR_7740239105,0.0,0.0,7000,7000,0
KR_7740239105,60.032,1.0,7015,7015,0
KR_7740239105,120.036,2.0,10216,9196,1020
KR_7740239105,180.059,3.0,13482,11948,1534
KR_7740239105,240.078,4.0,15779,15571,208
KR_7740239105,300.151,5.0,18551,18016,535
KR_7740239105,360.171,6.0,20983,20434,549
KR_7740239105,420.197,7.0,23697,23632,65
KR_7740239105,480.217,8.0,28149,26293,1856
KR_7740239105,540.246,9.0,31423,30484,939
KR_7740239105,600.272,10.0,34472,32980,1492
KR_7740239105,660.298,11.0,37407,36279,1128
KR_7740239105,720.317,12.01,39972,39708,264
KR_7740239105,780.328,13.01,43698,43858,-160
KR_7740239105,840.348,14.01,46968,47051,-83
KR_7740239105,900.38,15.01,49914,50244,-330
KR_7740239105,960.405,16.01,53084,53318,-234
KR_7740239105,1020.428,17.01,55556,56940,-1384
KR_7740239105,1080.448,18.01,58142,62679,-4537
KR_7740239105,1140.464,19.01,62178,65064,-2886
KR_7740239105,1194.689,19.91,64425,68780,-4355
KR_7763516348,0.0,0.0,7000,7000,0
KR_7763516348,60.009,1.0,7015,7015,0
KR_7763516348,120.028,2.0,9261,9511,-250
KR_7763516348,180.029,3.0,13748,13351,397
KR_7763516348,240.059,4.0,16591,16777,-186
KR_7763516348,300.145,5.0,21434,19838,1596
KR_7763516348,360.172,6.0,24626,23968,658
KR_7763516348,420.192,7.0,28087,27104,983
KR_7763516348,480.215,8.0,31260,30480,780
KR_7763516348,540.231,9.0,36397,34145,2252
KR_7763516348,600.259,10.0,38936,37863,1073
KR_7763516348,660.259,11.0,42752,41256,1496
KR_7763516348,720.287,12.0,45520,44571,949
KR_7763516348,780.295,13.0,47986,47191,795
KR_7763516348,840.327,14.01,52561,50376,2185
KR_7763516348,900.333,15.01,55916,54081,1835
KR_7763516348,960.365,16.01,58891,56535,2356
KR_7763516348,1020.393,17.01,62936,60215,2721
KR_7763516348,1080.413,18.01,65168,63791,1377
KR_7763516348,1140.42,19.01,69424,65943,3481
KR_7763516348,1200.434,20.01,72543,69552,2991
KR_7763516348,1260.458,21.01,75397,72210,3187
KR_7763516348,1320.466,22.01,77871,76426,1445
KR_7763516348,1380.473,23.01,82103,79192,2911
KR_7763516348,1440.494,24.01,84613,84383,230
KR_7763516348,1500.51,25.01,88532,87118,1414
KR_7763516348,1538.709,25.65,92196,88933,3263
KR_7777934317,0.0,0.0,7000,7000,0
KR_7777934317,60.031,1.0,7665,7803,-138
KR_7777934317,120.049,2.0,10464,12731,-2267
KR_7777934317,180.052,3.0,14007,15087,-1080
KR_7777934317,240.076,4.0,17955,20523,-2568
KR_7777934317,300.184,5.0,20537,24290,-3753
KR_7777934317,360.186,6.0,23682,27463,-3781
KR_7777934317,420.219,7.0,27758,30204,-2446
KR_7777934317,480.237,8.0,30632,34365,-3733
KR_7777934317,540.25,9.0,33641,38362,-4721
KR_7777934317,600.266,10.0,37673,41864,-4191
KR_7777934317,660.273,11.0,40530,45620,-5090
KR_7777934317,720.291,12.0,44548,49018,-4470
KR_7777934317,780.32,13.01,46881,53857,-6976
KR_7777934317,840.345,14.01,49766,56085,-6319
KR_7777934317,883.394,14.72,51507,60277,-8770
KR_7775316139,0.0,0.0,7000,7000,0
KR_7775316139,60.021,1.0,7885,7015,870
KR_7775316139,120.025,2.0,10102,9856,246
KR_7775316139,180.051,3.0,13324,12055,1269
KR_7775316139,240.078,4.0,16228,15748,480
KR_7775316139,300.155,5.0,19479,19157,322
KR_7775316139,360.173,6.0,22895,21726,1169
KR_7775316139,420.19,7.0,25407,25409,-2
KR_7775316139,480.209,8.0,28800,27908,892
KR_7775316139,540.225,9.0,33109,31279,1830
KR_7775316139,600.245,10.0,35813,34040,1773
KR_7775316139,660.249,11.0,39518,36663,2855
KR_7775316139,720.262,12.0,42497,39474,3023
KR_7775316139,780.274,13.0,45627,42050,3577
KR_7775316139,840.301,14.01,49017,48256,761
KR_7775316139,900.332,15.01,53486,50483,3003
KR_7775316139,960.341,16.01,57218,53098,4120
KR_7775316139,1020.349,17.01,60356,56458,3898
KR_7775316139,1080.374,18.01,63428,59393,4035
KR_7775316139,1140.402,19.01,67141,61922,5219
KR_7775316139,1200.421,20.01,71182,65936,5246
KR_7775316139,1260.437,21.01,74741,68677,6064
KR_7775316139,1320.441,22.01,77904,71524,6380
KR_7775316139,1380.448,23.01,80808,74677,6131
KR_7775316139,1440.478,24.01,83871,78056,5815
KR_7775316139,1500.495,25.01,87897,80829,7068
KR_7775316139,1560.526,26.01,90779,84304,6475
KR_7775316139,1620.555,27.01,93741,87132,6609
KR_7775316139,1675.008,27.92,99250,89261,9989
KR_7763309595,0.0,0.0,7000,7000,0
KR_7763309595,60.005,1.0,7015,7035,-20
KR_7763309595,120.026,2.0,9624,10508,-884
KR_7763309595,180.119,3.0,13554,14262,-708
KR_7763309595,240.142,4.0,16244,17274,-1030
KR_7763309595,300.149,5.0,18909,20545,-1636
KR_7763309595,360.181,6.0,22538,24005,-1467
KR_7763309595,420.21,7.0,26540,29247,-2707
KR_7763309595,480.24,8.0,30226,32238,-2012
KR_7763309595,540.257,9.0,33255,36686,-3431
KR_7763309595,600.282,10.0,36610,40279,-3669
KR_7763309595,660.282,11.0,41409,44061,-2652
KR_7763309595,720.305,12.01,43653,47680,-4027
KR_7763309595,780.338,13.01,46454,50042,-3588
KR_7763309595,840.368,14.01,50319,52874,-2555
KR_7763309595,900.387,15.01,53727,55424,-1697
KR_7763309595,960.39,16.01,56804,59164,-2360
KR_7763309595,1020.402,17.01,59825,61372,-1547
KR_7763309595,1080.415,18.01,61875,64594,-2719
KR_7763309595,1140.406,19.01,64094,69677,-5583
KR_7721934597,0.0,0.0,7000,7000,0
KR_7721934597,60.032,1.0,7015,7018,-3
KR_7721934597,120.053,2.0,10388,9795,593
KR_7721934597,180.107,3.0,12992,12284,708
KR_7721934597,240.125,4.0,15901,14976,925
KR_7721934597,300.14,5.0,19149,18265,884
KR_7721934597,360.163,6.0,22053,21198,855
KR_7721934597,420.178,7.0,25523,24538,985
KR_7721934597,480.197,8.0,27911,28167,-256
KR_7721934597,540.216,9.0,30646,30522,124
KR_7721934597,551.638,9.19,31291,31309,-18
KR_7765911364,0.0,0.0,7000,7000,0
KR_7765911364,60.009,1.0,7015,7015,0
KR_7765911364,120.028,2.0,9360,9383,-23
KR_7765911364,180.098,3.0,13529,13166,363
KR_7765911364,240.12,4.0,18154,17561,593
KR_7765911364,300.139,5.0,20962,20242,720
KR_7765911364,360.156,6.0,24907,23008,1899
KR_7765911364,420.179,7.0,28371,26885,1486
KR_7765911364,480.198,8.0,31458,29690,1768
KR_7765911364,540.225,9.0,34826,33728,1098
KR_7765911364,600.232,10.0,37994,37556,438
KR_7765911364,660.239,11.0,40481,40908,-427
KR_7765911364,720.263,12.0,43899,44064,-165
KR_7765911364,780.275,13.0,46265,46626,-361
KR_7765911364,840.295,14.0,49739,50309,-570
KR_7765911364,900.315,15.01,52881,53189,-308
KR_7765911364,960.338,16.01,56169,57176,-1007
KR_7765911364,1020.369,17.01,60427,59990,437
KR_7765911364,1080.397,18.01,63789,62754,1035
KR_7765911364,1140.422,19.01,66351,65702,649
KR_7765911364,1200.453,20.01,69432,69327,105
KR_7765911364,1260.465,21.01,71714,71941,-227
KR_7765911364,1320.483,22.01,74935,75146,-211
KR_7765911364,1380.489,23.01,78218,78092,126
KR_7765911364,1440.492,24.01,81301,81274,27
KR_7765911364,1500.505,25.01,84324,84406,-82
KR_7765911364,1549.269,25.82,86856,88073,-1217
KR_7739679667,0.0,0.0,7000,7000,0
KR_7739679667,60.028,1.0,7015,7041,-26
KR_7739679667,120.056,2.0,9536,10227,-691
KR_7739679667,180.125,3.0,11815,14110,-2295
KR_7739679667,240.149,4.0,14393,16513,-2120
KR_7739679667,300.158,5.0,18834,20617,-1783
KR_7739679667,360.182,6.0,21953,24030,-2077
KR_7739679667,420.192,7.0,24364,26497,-2133
KR_7739679667,480.223,8.0,26981,29717,-2736
KR_7739679667,540.23,9.0,31253,33120,-1867
KR_7739679667,600.262,10.0,34683,36596,-1913
KR_7739679667,660.275,11.0,37310,39596,-2286
KR_7739679667,720.292,12.0,41015,43324,-2309
KR_7739679667,780.316,13.01,44017,47649,-3632
KR_7739679667,840.319,14.01,48127,50484,-2357
KR_7739679667,900.326,15.01,51430,53337,-1907
KR_7739679667,960.349,16.01,53332,59382,-6050
KR_7739679667,1020.36,17.01,57269,63374,-6105
KR_7739679667,1080.375,18.01,59659,67699,-8040
KR_7739679667,1122.829,18.71,62676,70431,-7755
KR_7644820996,0.0,0.0,7000,7000,0
KR_7644820996,60.032,1.0,7015,7461,-446
KR_7644820996,120.039,2.0,10588,11884,-1296
KR_7644820996,180.062,3.0,13993,14169,-176
KR_7644820996,240.067,4.0,17965,17601,364
KR_7644820996,300.089,5.0,20177,21484,-1307
KR_7644820996,360.108,6.0,24702,25222,-520
KR_7644820996,420.173,7.0,27171,28697,-1526
KR_7644820996,480.206,8.0,29770,31838,-2068
KR_7644820996,540.219,9.0,33114,35614,-2500
KR_7644820996,600.245,10.0,36352,39431,-3079
KR_7644820996,660.25,11.0,38993,42652,-3659
KR_7644820996,720.282,12.0,43847,46202,-2355
KR_7644820996,780.315,13.01,46352,48572,-2220
KR_7644820996,840.331,14.01,48833,51707,-2874
KR_7644820996,900.342,15.01,51561,56431,-4870
KR_7644820996,960.37,16.01,55771,59162,-3391
KR_7644820996,1020.38,17.01,58223,61950,-3727
KR_7644820996,1080.389,18.01,62600,65138,-2538
KR_7644820996,1140.395,19.01,65467,67958,-2491
KR_7644820996,1200.403,20.01,67681,71122,-3441
KR_7644820996,1252.676,20.88,70158,75924,-5766
KR_7726160558,0.0,0.0,7000,7000,0
KR_7726160558,60.027,1.0,7015,7015,0
KR_7726160558,120.036,2.0,10514,9409,1105
KR_7726160558,180.097,3.0,14466,13898,568
KR_7726160558,240.116,4.0,18403,17172,1231
KR_7726160558,300.153,5.0,21266,20676,590
KR_7726160558,360.184,6.0,23522,23700,-178
KR_7726160558,420.185,7.0,27228,27698,-470
KR_7726160558,480.188,8.0,31811,31477,334
KR_7726160558,540.213,9.0,35591,34727,864
KR_7726160558,600.223,10.0,38522,38500,22
KR_7726160558,660.229,11.0,41417,42217,-800
KR_7726160558,720.232,12.0,46081,45870,211
KR_7726160558,780.253,13.0,48751,48252,499
KR_7726160558,840.279,14.0,54041,52107,1934
KR_7726160558,900.307,15.01,57605,54512,3093
KR_7726160558,928.536,15.48,58895,55718,3177
KR_7775148729,0.0,0.0,7000,7000,0
KR_7775148729,60.018,1.0,7015,7427,-412
KR_7775148729,120.024,2.0,11304,10404,900
KR_7775148729,180.042,3.0,15539,13321,2218
KR_7775148729,240.059,4.0,18809,16363,2446
KR_7775148729,300.122,5.0,21196,18974,2222
KR_7775148729,360.14,6.0,24787,22613,2174
KR_7775148729,420.152,7.0,27572,26094,1478
KR_7775148729,480.17,8.0,31432,29300,2132
KR_7775148729,540.201,9.0,34794,32541,2253
KR_7775148729,600.226,10.0,38110,34686,3424
KR_7775148729,660.249,11.0,41418,38152,3266
KR_7775148729,720.282,12.0,43899,41118,2781
KR_7775148729,780.312,13.01,48136,43919,4217
KR_7775148729,840.331,14.01,52095,46278,5817
KR_7775148729,900.34,15.01,56035,49836,6199
KR_7775148729,960.364,16.01,59096,52925,6171
KR_7775148729,1000.076,16.67,62633,54138,8495
KR_7644799833,0.0,0.0,7000,7000,0
KR_7644799833,60.008,1.0,7015,7427,-412
KR_7644799833,120.029,2.0,10269,11225,-956
KR_7644799833,180.11,3.0,13096,14285,-1189
KR_7644799833,240.134,4.0,16794,17504,-710
KR_7644799833,300.164,5.0,20032,20620,-588
KR_7644799833,360.186,6.0,23061,24494,-1433
KR_7644799833,420.203,7.0,26797,27354,-557
KR_7644799833,480.224,8.0,30072,30766,-694
KR_7644799833,540.244,9.0,33052,33447,-395
KR_7644799833,600.253,10.0,36907,36178,729
KR_7644799833,660.265,11.0,40611,39064,1547
KR_7644799833,720.294,12.0,45029,41768,3261
KR_7644799833,780.318,13.01,47239,46874,365
KR_7644799833,827.15,13.79,50318,48308,2010
KR_7721884510,0.0,0.0,7000,7000,0
KR_7721884510,60.013,1.0,7025,7015,10
KR_7721884510,120.024,2.0,9867,9310,557
KR_7721884510,180.041,3.0,12708,11692,1016
KR_7721884510,240.051,4.0,16161,15461,700
KR_7721884510,300.068,5.0,19117,18051,1066
KR_7721884510,360.093,6.0,22922,21878,1044
KR_7721884510,420.163,7.0,25765,24710,1055
KR_7721884510,480.175,8.0,28177,27994,183
KR_7721884510,540.175,9.0,31941,30969,972
KR_7721884510,600.194,10.0,34363,34001,362
KR_7721884510,660.213,11.0,38387,38295,92
KR_7721884510,720.231,12.0,41005,41610,-605
KR_7721884510,780.262,13.0,43702,44197,-495
KR_7721884510,840.291,14.0,47171,47690,-519
KR_7721884510,900.293,15.0,49910,50563,-653
KR_7721884510,922.436,15.37,50570,52398,-1828
KR_7771932753,0.0,0.0,7000,7000,0
KR_7771932753,60.032,1.0,7015,7021,-6
KR_7771932753,120.057,2.0,9339,9383,-44
KR_7771932753,180.059,3.0,12969,12061,908
KR_7771932753,240.087,4.0,15329,14619,710
KR_7771932753,300.171,5.0,18458,19167,-709
KR_7771932753,360.196,6.0,22068,22272,-204
KR_7771932753,420.228,7.0,24404,25255,-851
KR_7771932753,480.228,8.0,27075,29183,-2108
KR_7771932753,540.232,9.0,30734,32410,-1676
KR_7771932753,600.234,10.0,34294,36940,-2646
KR_7771932753,660.254,11.0,37209,40446,-3237
KR_7771932753,720.275,12.0,40652,43363,-2711
KR_7771932753,780.295,13.0,44111,47370,-3259
KR_7771932753,840.319,14.01,46545,49834,-3289
KR_7771932753,900.35,15.01,50534,53375,-2841
KR_7771932753,960.369,16.01,53278,56448,-3170
KR_7771932753,1020.401,17.01,57296,59495,-2199
KR_7771932753,1025.478,17.09,57446,59645,-2199
KR_7777022302,0.0,0.0,7000,7000,0
KR_7777022302,60.011,1.0,7015,7015,0
KR_7777022302,120.039,2.0,10330,10401,-71
KR_7777022302,180.116,3.0,13151,12988,163
KR_7777022302,240.135,4.0,16543,16527,16
KR_7777022302,300.153,5.0,19753,19744,9
KR_7777022302,360.173,6.0,22118,22005,113
KR_7777022302,420.194,7.0,24626,24324,302
KR_7777022302,480.218,8.0,29812,27749,2063
KR_7777022302,540.24,9.0,33235,30799,2436
KR_7777022302,571.884,9.53,34656,32245,2411
KR_7767091493,0.0,0.0,7000,7000,0
KR_7767091493,60.016,1.0,7015,7015,0
KR_7767091493,120.042,2.0,10021,10544,-523
KR_7767091493,180.114,3.0,13808,13712,96
KR_7767091493,240.138,4.0,17670,18698,-1028
KR_7767091493,300.143,5.0,22109,21779,330
KR_7767091493,360.165,6.0,24910,25395,-485
KR_7767091493,420.178,7.0,27378,29705,-2327
KR_7767091493,480.211,8.0,30970,32741,-1771
KR_7767091493,540.242,9.0,33832,35650,-1818
KR_7767091493,600.267,10.0,35943,39033,-3090
KR_7767091493,660.271,11.0,40276,43149,-2873
KR_7767091493,720.291,12.0,43835,47286,-3451
KR_7767091493,780.309,13.01,47143,49487,-2344
KR_7767091493,840.311,14.01,50431,52976,-2545
KR_7767091493,900.339,15.01,53231,55270,-2039
KR_7767091493,960.34,16.01,56927,60523,-3596
KR_7767091493,1020.347,17.01,60568,63696,-3128
KR_7767091493,1080.369,18.01,63465,65961,-2496
KR_7767091493,1140.393,19.01,66207,70235,-4028
KR_7767091493,1147.808,19.13,66432,70510,-4078
KR_7765988061,0.0,0.0,7000,7000,0
KR_7765988061,60.017,1.0,7346,7437,-91
KR_7765988061,120.019,2.0,10891,10401,490
KR_7765988061,180.039,3.0,14171,13347,824
KR_7765988061,240.049,4.0,16848,15788,1060
KR_7765988061,300.131,5.0,20635,21061,-426
KR_7765988061,360.15,6.0,24992,24039,953
KR_7765988061,420.154,7.0,27983,26288,1695
KR_7765988061,480.186,8.0,30975,29986,989
KR_7765988061,540.192,9.0,33812,32365,1447
KR_7765988061,600.221,10.0,38312,35386,2926
KR_7765988061,660.253,11.0,42817,38893,3924
KR_7765988061,720.279,12.0,45980,41410,4570
KR_7765988061,780.289,13.0,48860,44061,4799
KR_7765988061,809.897,13.5,50398,45043,5355
KR_7733025428,0.0,0.0,7000,7000,0
KR_7733025428,60.028,1.0,7015,7015,0
KR_7733025428,120.039,2.0,9297,10004,-707
KR_7733025428,180.052,3.0,11859,12729,-870
KR_7733025428,240.067,4.0,15472,15389,83
KR_7733025428,300.08,5.0,17775,18688,-913
KR_7733025428,360.108,6.0,22561,20984,1577
KR_7733025428,420.155,7.0,25371,24964,407
KR_7733025428,480.167,8.0,29784,27077,2707
KR_7733025428,540.224,9.0,33472,30757,2715
KR_7733025428,600.242,10.0,37033,35042,1991
KR_7733025428,660.247,11.0,40454,38588,1866
KR_7733025428,720.26,12.0,44947,42210,2737
KR_7733025428,780.271,13.0,48418,45243,3175
KR_7733025428,840.284,14.0,52499,48741,3758
KR_7733025428,900.304,15.01,54685,51243,3442
KR_7733025428,960.329,16.01,57095,55608,1487
KR_7733025428,1017.248,16.95,61732,57359,4373
KR_7726097849,0.0,0.0,7000,7000,0
KR_7726097849,60.026,1.0,7015,7032,-17
KR_7726097849,120.044,2.0,10758,9309,1449
KR_7726097849,180.13,3.0,14390,13351,1039
KR_7726097849,240.162,4.0,18197,17610,587
KR_7726097849,300.185,5.0,22065,21486,579
KR_7726097849,360.21,6.0,25879,25110,769
KR_7726097849,420.231,7.0,29180,28097,1083
KR_7726097849,480.259,8.0,32024,31499,525
KR_7726097849,540.288,9.0,35716,34559,1157
KR_7726097849,600.3,10.0,39906,37781,2125
KR_7726097849,660.315,11.01,42816,41778,1038
KR_7726097849,720.325,12.01,45724,44839,885
KR_7726097849,780.35,13.01,48233,49825,-1592
KR_7726097849,840.365,14.01,52248,52691,-443
KR_7726097849,900.392,15.01,55064,57366,-2302
KR_7726097849,960.409,16.01,58399,59817,-1418
KR_7726097849,1020.422,17.01,61444,64763,-3319
KR_7726097849,1080.429,18.01,65017,68802,-3785
KR_7726097849,1140.437,19.01,67791,72120,-4329
KR_7726097849,1157.672,19.29,68542,73258,-4716
KR_7767306549,0.0,0.0,7000,7000,0
KR_7767306549,60.032,1.0,7015,7015,0
KR_7767306549,120.033,2.0,9716,10038,-322
KR_7767306549,180.062,3.0,13694,13848,-154
KR_7767306549,240.069,4.0,16458,17005,-547
KR_7767306549,300.077,5.0,19366,21957,-2591
KR_7767306549,360.104,6.0,23938,25086,-1148
KR_7767306549,420.207,7.0,26207,28280,-2073
KR_7767306549,480.234,8.0,29059,31510,-2451
KR_7767306549,540.258,9.0,31985,35110,-3125
KR_7767306549,600.288,10.0,35932,39357,-3425
KR_7767306549,660.304,11.01,38181,43180,-4999
KR_7767306549,720.333,12.01,42172,46221,-4049
KR_7767306549,780.358,13.01,44484,49604,-5120
KR_7767306549,840.372,14.01,48389,52696,-4307
KR_7767306549,900.381,15.01,51234,55672,-4438
KR_7767306549,960.399,16.01,54335,59897,-5562
KR_7767306549,1020.424,17.01,56994,62575,-5581
KR_7767306549,1080.449,18.01,60364,65759,-5395
KR_7767306549,1140.452,19.01,64534,68301,-3767
KR_7767306549,1200.458,20.01,69558,70742,-1184
KR_7767306549,1260.478,21.01,72353,74524,-2171
KR_7767306549,1298.565,21.64,73511,77924,-4413
KR_7773144027,0.0,0.0,7000,7000,0
KR_7773144027,60.031,1.0,7015,7377,-362
KR_7773144027,120.038,2.0,11180,9541,1639
KR_7773144027,180.052,3.0,14068,11915,2153
KR_7773144027,240.052,4.0,16470,15847,623
KR_7773144027,300.054,5.0,20277,18317,1960
KR_7773144027,360.057,6.0,23434,22041,1393
KR_7773144027,420.077,7.0,27912,24786,3126
KR_7773144027,480.088,8.0,30173,27753,2420
KR_7773144027,540.151,9.0,32521,30356,2165
KR_7773144027,600.174,10.0,35483,33461,2022
KR_7773144027,660.185,11.0,37998,36599,1399
KR_7773144027,720.188,12.0,41690,40083,1607
KR_7773144027,780.208,13.0,43881,42760,1121
KR_7773144027,840.21,14.0,47419,46279,1140
KR_7773144027,900.238,15.0,49785,48977,808
KR_7773144027,960.245,16.0,52417,51871,546
KR_7773144027,1020.256,17.0,54753,54891,-138
KR_7773144027,1046.501,17.44,55752,56353,-601
KR_7778873869,0.0,0.0,7000,7000,0
KR_7778873869,60.03,1.0,7939,7691,248
KR_7778873869,120.061,2.0,12108,10271,1837
KR_7778873869,180.143,3.0,14914,14024,890
KR_7778873869,240.145,4.0,17237,16997,240
KR_7778873869,300.174,5.0,20146,20707,-561
KR_7778873869,360.196,6.0,24871,24199,672
KR_7778873869,420.217,7.0,28112,27322,790
KR_7778873869,480.241,8.0,31618,30633,985
KR_7778873869,540.253,9.0,33780,35106,-1326
KR_7778873869,600.276,10.0,37943,38178,-235
KR_7778873869,660.289,11.0,40809,41939,-1130
KR_7778873869,720.312,12.01,43463,45459,-1996
KR_7778873869,780.337,13.01,45822,50045,-4223
KR_7778873869,806.825,13.45,46959,52028,-5069
KR_7747623857,0.0,0.0,7000,7000,0
KR_7747623857,60.031,1.0,7019,7015,4
KR_7747623857,120.035,2.0,11763,10647,1116
KR_7747623857,180.053,3.0,15100,13437,1663
KR_7747623857,240.08,4.0,17678,16881,797
KR_7747623857,300.086,5.0,22148,21109,1039
KR_7747623857,360.115,6.0,24542,24025,517
KR_7747623857,420.188,7.0,28145,27412,733
KR_7747623857,480.204,8.0,32145,30528,1617
KR_7747623857,540.225,9.0,36019,34093,1926
KR_7747623857,600.245,10.0,39656,38024,1632
KR_7747623857,660.249,11.0,43316,41333,1983
KR_7747623857,720.271,12.0,46709,45364,1345
KR_7747623857,780.276,13.0,49664,49806,-142
KR_7747623857,840.309,14.01,52315,53307,-992
KR_7747623857,900.32,15.01,54932,55702,-770
KR_7747623857,960.342,16.01,60592,58468,2124
KR_7747623857,1020.366,17.01,63536,62560,976
KR_7747623857,1080.388,18.01,66605,67000,-395
KR_7747623857,1140.412,19.01,69836,70110,-274
KR_7747623857,1200.423,20.01,73664,73475,189
KR_7747623857,1260.424,21.01,76611,76158,453
KR_7747623857,1320.427,22.01,80242,78700,1542
KR_7747623857,1380.43,23.01,84169,83004,1165
KR_7747623857,1440.432,24.01,87289,87172,117
KR_7747623857,1500.46,25.01,89997,89980,17
KR_7747623857,1560.484,26.01,92640,93128,-488
KR_7747623857,1620.498,27.01,97889,95467,2422
KR_7747623857,1620.999,27.02,97904,95482,2422
KR_7776768243,0.0,0.0,7000,7000,0
KR_7776768243,60.015,1.0,7316,8416,-1100
KR_7776768243,120.042,2.0,11249,12349,-1100
KR_7776768243,180.117,3.0,13619,14971,-1352
KR_7776768243,240.14,4.0,18642,17663,979
KR_7776768243,300.161,5.0,21203,21957,-754
KR_7776768243,360.163,6.0,26728,24011,2717
KR_7776768243,420.182,7.0,30551,30183,368
KR_7776768243,480.204,8.0,33158,33937,-779
KR_7776768243,540.226,9.0,36889,36921,-32
KR_7776768243,600.236,10.0,40824,39844,980
KR_7776768243,660.255,11.0,43864,43729,135
KR_7776768243,720.277,12.0,46615,46636,-21
KR_7776768243,780.277,13.0,51223,49401,1822
KR_7776768243,840.297,14.0,55392,53401,1991
KR_7776768243,900.308,15.01,58824,56410,2414
KR_7776768243,960.323,16.01,62691,59110,3581
KR_7776768243,969.241,16.15,62961,59380,3581
KR_7765984263,0.0,0.0,7000,7000,0
KR_7765984263,60.007,1.0,7777,7373,404
KR_7765984263,120.01,2.0,11262,11480,-218
KR_7765984263,180.024,3.0,14348,15447,-1099
KR_7765984263,240.039,4.0,18716,18930,-214
KR_7765984263,300.145,5.0,21543,22341,-798
KR_7765984263,360.16,6.0,24025,25057,-1032
KR_7765984263,420.18,7.0,27612,28429,-817
KR_7765984263,480.198,8.0,30038,31995,-1957
KR_7765984263,540.223,9.0,33806,35724,-1918
KR_7765984263,600.242,10.0,36311,39138,-2827
KR_7765984263,660.273,11.0,39661,42290,-2629
KR_7765984263,720.282,12.0,43044,47198,-4154
KR_7765984263,780.301,13.01,46101,49780,-3679
KR_7765984263,840.308,14.01,50849,52008,-1159
KR_7765984263,900.335,15.01,52887,55497,-2610
KR_7765984263,960.351,16.01,56472,58207,-1735
KR_7765984263,1020.354,17.01,59674,60892,-1218
KR_7765984263,1080.363,18.01,63525,63779,-254
KR_7765984263,1140.379,19.01,66567,67821,-1254
KR_7765984263,1200.383,20.01,69836,70272,-436
KR_7765984263,1260.398,21.01,72382,73626,-1244
KR_7765984263,1320.429,22.01,75628,76754,-1126
KR_7765984263,1380.454,23.01,78023,81646,-3623
KR_7765984263,1390.84,23.18,78338,82034,-3696
KR_7749284831,0.0,0.0,7000,7000,0
KR_7749284831,60.025,1.0,7015,7015,0
KR_7749284831,120.029,2.0,9193,9565,-372
KR_7749284831,180.045,3.0,11556,11992,-436
KR_7749284831,240.054,4.0,14417,14794,-377
KR_7749284831,300.069,5.0,16801,17803,-1002
KR_7749284831,360.086,6.0,20845,20638,207
KR_7749284831,420.093,7.0,24276,25526,-1250
KR_7749284831,480.096,8.0,26792,28442,-1650
KR_7749284831,540.102,9.0,29606,31979,-2373
KR_7749284831,600.103,10.0,33265,35599,-2334
KR_7749284831,660.105,11.0,35569,38325,-2756
KR_7749284831,720.118,12.0,39410,41264,-1854
KR_7749284831,780.119,13.0,41679,45456,-3777
KR_7749284831,815.271,13.59,43597,48140,-4543
KR_7777200302,0.0,0.0,7000,7000,0
KR_7777200302,60.027,1.0,7015,7445,-430
KR_7777200302,120.054,2.0,9347,9741,-394
KR_7777200302,180.139,3.0,12735,13765,-1030
KR_7777200302,240.155,4.0,15247,16497,-1250
KR_7777200302,300.172,5.0,18834,19178,-344
KR_7777200302,360.205,6.0,21806,21407,399
KR_7777200302,420.211,7.0,25531,25399,132
KR_7777200302,480.231,8.0,28852,27924,928
KR_7777200302,540.238,9.0,31423,31402,21
KR_7777200302,600.262,10.0,34473,33937,536
KR_7777200302,660.286,11.0,37574,36565,1009
KR_7777200302,720.305,12.01,40592,42309,-1717
KR_7777200302,780.319,13.01,43407,44903,-1496
KR_7777200302,840.343,14.01,49358,47514,1844
KR_7777200302,900.369,15.01,52300,50563,1737
KR_7777200302,960.385,16.01,54684,53743,941
KR_7777200302,1020.393,17.01,57584,56332,1252
KR_7777200302,1080.414,18.01,61251,59373,1878
KR_7777200302,1140.433,19.01,63793,62656,1137
KR_7777200302,1200.453,20.01,66462,65269,1193
KR_7777200302,1260.466,21.01,71466,68497,2969
KR_7777200302,1320.486,22.01,73948,71533,2415
KR_7777200302,1380.487,23.01,77038,73942,3096
KR_7777200302,1403.455,23.39,78459,74957,3502
KR_7628166164,0.0,0.0,7000,7000,0
KR_7628166164,60.025,1.0,7015,7379,-364
KR_7628166164,120.037,2.0,9302,10382,-1080
KR_7628166164,180.119,3.0,12491,13002,-511
KR_7628166164,240.139,4.0,15657,15617,40
KR_7628166164,300.145,5.0,19497,19156,341
KR_7628166164,360.16,6.0,22357,21805,552
KR_7628166164,420.175,7.0,25199,24844,355
KR_7628166164,480.183,8.0,29078,28212,866
KR_7628166164,540.216,9.0,31516,31869,-353
KR_7628166164,600.238,10.0,36001,33977,2024
KR_7628166164,660.269,11.0,38511,37996,515
KR_7628166164,720.288,12.0,41879,41655,224
KR_7628166164,780.299,13.0,45212,44060,1152
KR_7628166164,840.3,14.0,47717,48341,-624
KR_7628166164,900.301,15.01,51024,51504,-480
KR_7628166164,960.333,16.01,53166,54731,-1565
KR_7628166164,1020.343,17.01,56099,57019,-920
KR_7628166164,1080.363,18.01,60706,59762,944
KR_7628166164,1140.367,19.01,62863,63749,-886
KR_7628166164,1200.381,20.01,66216,68316,-2100
KR_7628166164,1260.39,21.01,69167,70698,-1531
KR_7628166164,1309.986,21.83,71271,73578,-2307
KR_7766530502,0.0,0.0,7000,7000,0
KR_7766530502,60.008,1.0,7447,7015,432
KR_7766530502,120.033,2.0,9967,11122,-1155
KR_7766530502,180.133,3.0,13026,14593,-1567
KR_7766530502,240.165,4.0,16959,17985,-1026
KR_7766530502,300.172,5.0,19749,21250,-1501
KR_7766530502,360.182,6.0,23464,24735,-1271
KR_7766530502,420.207,7.0,25695,27583,-1888
KR_7766530502,480.22,8.0,29862,30715,-853
KR_7766530502,540.229,9.0,32157,33114,-957
KR_7766530502,600.229,10.0,34843,38092,-3249
KR_7766530502,660.256,11.0,37581,41494,-3913
KR_7766530502,720.278,12.0,41787,44103,-2316
KR_7766530502,780.285,13.0,44721,47914,-3193
KR_7766530502,840.299,14.0,47456,51327,-3871
KR_7766530502,900.311,15.01,50199,55608,-5409
KR_7766530502,960.34,16.01,55312,57844,-2532
KR_7766530502,1020.367,17.01,57970,61658,-3688
KR_7766530502,1080.375,18.01,60883,64269,-3386
KR_7766530502,1140.402,19.01,64601,67313,-2712
KR_7766530502,1200.433,20.01,66831,70610,-3779
KR_7766530502,1260.438,21.01,69944,74473,-4529
KR_7766530502,1320.454,22.01,72562,76669,-4107
KR_7766530502,1380.487,23.01,76983,80082,-3099
KR_7766530502,1440.492,24.01,79623,82405,-2782
KR_7766530502,1500.494,25.01,83867,85685,-1818
KR_7766530502,1560.515,26.01,87120,88903,-1783
KR_7766530502,1612.814,26.88,88970,93506,-4536
KR_7724081460,0.0,0.0,7000,7000,0
KR_7724081460,60.024,1.0,7025,7015,10
KR_7724081460,120.057,2.0,9705,9338,367
KR_7724081460,180.112,3.0,12824,12279,545
KR_7724081460,240.139,4.0,15510,14612,898
KR_7724081460,300.156,5.0,18324,17107,1217
KR_7724081460,360.162,6.0,21287,20383,904
KR_7724081460,420.164,7.0,25262,23347,1915
KR_7724081460,480.193,8.0,27750,26574,1176
KR_7724081460,540.208,9.0,30728,29202,1526
KR_7724081460,600.224,10.0,33436,34730,-1294
KR_7724081460,660.25,11.0,36606,36914,-308
KR_7724081460,720.283,12.0,38926,39457,-531
KR_7724081460,780.292,13.0,41495,43386,-1891
KR_7724081460,840.319,14.01,44878,45833,-955
KR_7724081460,900.339,15.01,47073,48699,-1626
KR_7724081460,960.345,16.01,50510,52393,-1883
KR_7724081460,1020.358,17.01,52934,54889,-1955
KR_7724081460,1080.385,18.01,56154,57703,-1549
KR_7724081460,1140.412,19.01,58706,60729,-2023
KR_7724081460,1200.443,20.01,63378,63694,-316
KR_7724081460,1260.46,21.01,66097,67450,-1353
KR_7724081460,1320.479,22.01,68789,70598,-1809
KR_7724081460,1380.508,23.01,71108,75051,-3943
KR_7724081460,1430.24,23.84,74795,77351,-2556
KR_7778124710,0.0,0.0,7000,7000,0
KR_7778124710,60.0,1.0,7015,7487,-472
KR_7778124710,120.021,2.0,10095,10446,-351
KR_7778124710,180.085,3.0,13764,13508,256
KR_7778124710,240.103,4.0,17387,18027,-640
KR_7778124710,300.134,5.0,21302,20749,553
KR_7778124710,360.157,6.0,23801,24841,-1040
KR_7778124710,420.168,7.0,28339,28185,154
KR_7778124710,480.188,8.0,30694,31030,-336
KR_7778124710,540.208,9.0,32903,35922,-3019
KR_7778124710,600.222,10.0,38523,38689,-166
KR_7778124710,660.238,11.0,41449,42319,-870
KR_7778124710,720.268,12.0,44521,45779,-1258
KR_7778124710,780.299,13.0,48570,49628,-1058
KR_7778124710,840.301,14.01,50935,53251,-2316
KR_7778124710,900.301,15.01,54871,56867,-1996
KR_7778124710,960.301,16.01,57510,59082,-1572
KR_7778124710,1020.315,17.01,60951,62167,-1216
KR_7778124710,1080.341,18.01,64947,66211,-1264
KR_7778124710,1140.345,19.01,67660,68664,-1004
KR_7778124710,1200.361,20.01,70251,71250,-999
KR_7778124710,1260.368,21.01,72822,76253,-3431
KR_7778124710,1271.59,21.19,73402,77493,-4091
KR_7778947330,0.0,0.0,7000,7000,0
KR_7778947330,60.019,1.0,7015,7477,-462
KR_7778947330,120.041,2.0,10486,10688,-202
KR_7778947330,180.107,3.0,13410,14753,-1343
KR_7778947330,240.127,4.0,15810,17525,-1715
KR_7778947330,300.147,5.0,19963,19928,35
KR_7778947330,360.176,6.0,23671,23705,-34
KR_7778947330,420.193,7.0,26026,27074,-1048
KR_7778947330,480.212,8.0,30027,32093,-2066
KR_7778947330,540.212,9.0,32546,34731,-2185
KR_7778947330,600.228,10.0,37391,38788,-1397
KR_7778947330,660.242,11.0,40704,42034,-1330
KR_7778947330,720.261,12.0,43639,45883,-2244
KR_7778947330,780.285,13.0,47858,49304,-1446
KR_7778947330,840.306,14.01,51048,52025,-977
KR_7778947330,900.321,15.01,53535,56003,-2468
KR_7778947330,960.351,16.01,58506,58818,-312
KR_7778947330,1020.378,17.01,61659,62471,-812
KR_7778947330,1080.408,18.01,64350,65016,-666
KR_7778947330,1140.412,19.01,68153,68206,-53
KR_7778947330,1200.432,20.01,71011,71944,-933
KR_7778947330,1260.455,21.01,75445,74626,819
KR_7778947330,1284.705,21.41,77658,75361,2297
KR_7747694021,0.0,0.0,7000,7000,0
KR_7747694021,60.006,1.0,7015,7527,-512
KR_7747694021,120.017,2.0,10373,11997,-1624
KR_7747694021,180.037,3.0,12754,15316,-2562
KR_7747694021,240.04,4.0,17402,18184,-782
KR_7747694021,300.06,5.0,20674,22611,-1937
KR_7747694021,360.09,6.0,23385,26406,-3021
KR_7747694021,420.168,7.0,27938,29441,-1503
KR_7747694021,480.187,8.0,32245,32125,120
KR_7747694021,540.206,9.0,35011,35474,-463
KR_7747694021,600.227,10.0,38175,39306,-1131
KR_7747694021,660.26,11.0,40553,42282,-1729
KR_7747694021,720.281,12.0,43566,46618,-3052
KR_7747694021,780.309,13.01,47149,49151,-2002
KR_7747694021,840.331,14.01,51597,52611,-1014
KR_7747694021,900.348,15.01,55047,55964,-917
KR_7747694021,960.372,16.01,58438,59109,-671
KR_7747694021,1020.383,17.01,60949,62089,-1140
KR_7747694021,1080.4,18.01,63113,65135,-2022
KR_7747694021,1140.43,19.01,67072,67929,-857
KR_7747694021,1200.446,20.01,69390,70869,-1479
KR_7747694021,1260.447,21.01,72133,73260,-1127
KR_7747694021,1320.463,22.01,74673,77174,-2501
KR_7747694021,1380.467,23.01,78847,79910,-1063
KR_7747694021,1440.487,24.01,81191,83258,-2067
KR_7747694021,1500.519,25.01,86321,85364,957
KR_7747694021,1507.065,25.12,86551,85544,1007
KR_7775109230,0.0,0.0,7000,7000,0
KR_7775109230,60.003,1.0,7706,7645,61
KR_7775109230,120.02,2.0,9975,9978,-3
KR_7775109230,180.086,3.0,13204,12657,547
KR_7775109230,240.109,4.0,15864,15702,162
KR_7775109230,300.11,5.0,19101,18132,969
KR_7775109230,360.127,6.0,22490,22445,45
KR_7775109230,420.14,7.0,25072,25237,-165
KR_7775109230,480.165,8.0,30140,27910,2230
KR_7775109230,540.185,9.0,32641,30434,2207
KR_7775109230,600.212,10.0,36201,33168,3033
KR_7775109230,660.233,11.0,38992,38122,870
KR_7775109230,720.266,12.0,42318,41378,940
KR_7775109230,780.269,13.0,44921,43860,1061
KR_7775109230,840.276,14.0,48759,46487,2272
KR_7775109230,900.295,15.0,51651,50372,1279
KR_7775109230,960.324,16.01,54870,53227,1643
KR_7775109230,1020.325,17.01,58370,55917,2453
KR_7775109230,1061.143,17.69,62208,57319,4889
KR_7763581842,0.0,0.0,7000,7000,0
KR_7763581842,60.027,1.0,8156,7746,410
KR_7763581842,120.05,2.0,12215,10701,1514
KR_7763581842,180.132,3.0,15194,14603,591
KR_7763581842,240.152,4.0,18910,18593,317
KR_7763581842,300.168,5.0,21813,22193,-380
KR_7763581842,360.194,6.0,25576,25006,570
KR_7763581842,420.199,7.0,29389,29318,71
KR_7763581842,480.224,8.0,33029,33362,-333
KR_7763581842,540.236,9.0,36622,36213,409
KR_7763581842,600.267,10.0,39845,38654,1191
KR_7763581842,660.28,11.0,42794,41910,884
KR_7763581842,720.3,12.0,47390,44533,2857
KR_7763581842,780.315,13.01,50796,47623,3173
KR_7763581842,840.324,14.01,54216,50496,3720
KR_7763581842,900.357,15.01,57284,55150,2134
KR_7763581842,960.379,16.01,60168,57635,2533
KR_7763581842,1020.404,17.01,65292,60072,5220
KR_7763581842,1044.084,17.4,66512,61302,5210
KR_7756584694,0.0,0.0,7000,7000,0
KR_7756584694,60.008,1.0,7765,7432,333
KR_7756584694,120.032,2.0,10790,10779,11
KR_7756584694,180.129,3.0,13953,13608,345
KR_7756584694,240.156,4.0,17115,17658,-543
KR_7756584694,300.182,5.0,20214,20130,84
KR_7756584694,360.209,6.0,23124,23289,-165
KR_7756584694,420.227,7.0,26397,26539,-142
KR_7756584694,480.259,8.0,29620,30198,-578
KR_7756584694,540.288,9.0,33061,33292,-231
KR_7756584694,600.299,10.0,36041,37706,-1665
KR_7756584694,660.301,11.01,39408,41250,-1842
KR_7756584694,720.33,12.01,42611,44411,-1800
KR_7756584694,780.362,13.01,45135,48128,-2993
KR_7756584694,840.375,14.01,48625,51695,-3070
KR_7756584694,891.343,14.86,50395,55342,-4947
KR_7769056946,0.0,0.0,7000,7000,0
KR_7769056946,60.005,1.0,7315,7477,-162
KR_7769056946,120.037,2.0,10276,10697,-421
KR_7769056946,180.133,3.0,12596,13685,-1089
KR_7769056946,240.158,4.0,15775,17544,-1769
KR_7769056946,300.188,5.0,19148,21634,-2486
KR_7769056946,360.212,6.0,21173,24791,-3618
KR_7769056946,420.24,7.0,23634,28149,-4515
KR_7769056946,480.241,8.0,27377,31409,-4032
KR_7769056946,540.256,9.0,30849,34582,-3733
KR_7769056946,600.257,10.0,33432,38825,-5393
KR_7769056946,660.281,11.0,36330,42489,-6159
KR_7769056946,720.299,12.0,38836,46095,-7259
KR_7769056946,780.302,13.01,44000,49833,-5833
KR_7769056946,840.31,14.01,46127,53503,-7376
KR_7769056946,846.49,14.11,46307,54134,-7827
KR_7766977697,0.0,0.0,7000,7000,0
KR_7766977697,60.023,1.0,7545,7323,222
KR_7766977697,120.052,2.0,11368,10336,1032
KR_7766977697,180.132,3.0,15087,13265,1822
KR_7766977697,240.151,4.0,18308,17034,1274
KR_7766977697,300.164,5.0,21854,19598,2256
KR_7766977697,360.189,6.0,24571,23402,1169
KR_7766977697,420.2,7.0,28906,26831,2075
KR_7766977697,480.212,8.0,32158,30061,2097
KR_7766977697,540.232,9.0,35342,33263,2079
KR_7766977697,600.253,10.0,39983,36779,3204
KR_7766977697,660.284,11.0,43271,39583,3688
KR_7766977697,720.305,12.01,46410,41959,4451
KR_7766977697,780.327,13.01,50083,46456,3627
KR_7766977697,840.338,14.01,53027,49225,3802
KR_7766977697,900.363,15.01,55511,51653,3858
KR_7766977697,960.368,16.01,59171,54592,4579
KR_7766977697,1020.386,17.01,61415,58826,2589
KR_7766977697,1080.393,18.01,65430,62558,2872
KR_7766977697,1140.404,19.01,68263,65340,2923
KR_7766977697,1200.435,20.01,72694,68258,4436
KR_7766977697,1260.437,21.01,75934,71831,4103
KR_7766977697,1320.451,22.01,78222,75136,3086
KR_7766977697,1380.484,23.01,82297,78952,3345
KR_7766977697,1440.487,24.01,85495,81488,4007
KR_7766977697,1500.515,25.01,91038,84695,6343
KR_7766977697,1560.518,26.01,93473,89068,4405
KR_7766977697,1620.542,27.01,96086,93519,2567
KR_7766977697,1622.012,27.03,96116,93549,2567
KR_7721803409,0.0,0.0,7000,7000,0
KR_7721803409,60.022,1.0,7015,7015,0
KR_7721803409,120.05,2.0,9581,10980,-1399
KR_7721803409,180.141,3.0,12988,15123,-2135
KR_7721803409,240.147,4.0,16430,19475,-3045
KR_7721803409,300.176,5.0,18836,23970,-5134
KR_7721803409,360.207,6.0,22560,27502,-4942
KR_7721803409,420.227,7.0,25790,30418,-4628
KR_7721803409,480.256,8.0,29135,34299,-5164
KR_7721803409,540.262,9.0,31564,37887,-6323
KR_7721803409,600.288,10.0,35976,41545,-5569
KR_7721803409,660.297,11.0,39273,45769,-6496
KR_7721803409,720.321,12.01,43198,50318,-7120
KR_7721803409,780.325,13.01,46534,53436,-6902
KR_7721803409,840.335,14.01,49185,57059,-7874
KR_7721803409,900.359,15.01,52766,59918,-7152
KR_7721803409,960.36,16.01,55746,63810,-8064
KR_7721803409,1020.391,17.01,58579,66259,-7680
KR_7721803409,1055.429,17.59,60845,67686,-6841
KR_7740200766,0.0,0.0,7000,7000,0
KR_7740200766,60.015,1.0,7015,7015,0
KR_7740200766,120.017,2.0,10182,9894,288
KR_7740200766,180.035,3.0,13657,13351,306
KR_7740200766,240.041,4.0,17806,16815,991
KR_7740200766,300.059,5.0,20576,20329,247
KR_7740200766,360.072,6.0,23078,23599,-521
KR_7740200766,420.088,7.0,25976,26548,-572
KR_7740200766,480.097,8.0,30474,30828,-354
KR_7740200766,540.117,9.0,33155,33895,-740
KR_7740200766,600.138,10.0,36847,38159,-1312
KR_7740200766,660.212,11.0,39567,42210,-2643
KR_7740200766,720.23,12.0,42404,45403,-2999
KR_7740200766,780.235,13.0,46232,48809,-2577
KR_7740200766,840.252,14.0,48123,53689,-5566
KR_7740200766,900.274,15.0,50813,58579,-7766
KR_7740200766,902.779,15.05,50888,58654,-7766
KR_7758478874,0.0,0.0,7000,7000,0
KR_7758478874,60.003,1.0,7400,7015,385
KR_7758478874,120.021,2.0,9901,10219,-318
KR_7758478874,180.089,3.0,13695,14046,-351
KR_7758478874,240.113,4.0,16512,17502,-990
KR_7758478874,300.12,5.0,19983,19825,158
KR_7758478874,360.152,6.0,22593,23911,-1318
KR_7758478874,420.155,7.0,26303,26109,194
KR_7758478874,480.17,8.0,28969,29000,-31
KR_7758478874,540.2,9.0,31667,32854,-1187
KR_7758478874,600.213,10.0,36461,35056,1405
KR_7758478874,660.22,11.0,39044,39148,-104
KR_7758478874,720.245,12.0,42634,41383,1251
KR_7758478874,780.251,13.0,45216,46169,-953
KR_7758478874,840.268,14.0,47839,49237,-1398
KR_7758478874,869.195,14.49,49009,51012,-2003
KR_7775399306,0.0,0.0,7000,7000,0
KR_7775399306,60.032,1.0,7015,7447,-432
KR_7775399306,120.038,2.0,9677,10277,-600
KR_7775399306,180.057,3.0,12148,12805,-657
KR_7775399306,240.076,4.0,15250,16229,-979
KR_7775399306,300.162,5.0,17534,19336,-1802
KR_7775399306,360.181,6.0,20193,22316,-2123
KR_7775399306,420.211,7.0,24290,27286,-2996
KR_7775399306,480.239,8.0,28745,29769,-1024
KR_7775399306,540.268,9.0,31640,32880,-1240
KR_7775399306,600.275,10.0,34083,36793,-2710
KR_7775399306,660.284,11.0,38184,40099,-1915
KR_7775399306,720.292,12.0,40891,44323,-3432
KR_7775399306,780.316,13.01,43632,46658,-3026
KR_7775399306,840.349,14.01,47164,49435,-2271
KR_7775399306,900.366,15.01,49767,52838,-3071
KR_7775399306,960.375,16.01,53252,55384,-2132
KR_7775399306,1020.397,17.01,55719,57994,-2275
KR_7775399306,1080.43,18.01,58256,62954,-4698
KR_7775399306,1123.404,18.72,60181,65689,-5508
KR_7769156234,0.0,0.0,7000,7000,0
KR_7769156234,60.031,1.0,7015,7015,0
KR_7769156234,120.034,2.0,9706,10363,-657
KR_7769156234,180.055,3.0,12645,13505,-860
KR_7769156234,240.063,4.0,15557,17106,-1549
KR_7769156234,300.083,5.0,20093,20265,-172
KR_7769156234,360.101,6.0,23929,23822,107
KR_7769156234,420.166,7.0,26738,27624,-886
KR_7769156234,480.188,8.0,29421,30315,-894
KR_7769156234,540.203,9.0,33321,34137,-816
KR_7769156234,600.223,10.0,36366,36455,-89
KR_7769156234,660.246,11.0,38734,39202,-468
KR_7769156234,720.271,12.0,42579,42533,46
KR_7769156234,780.274,13.0,45905,45701,204
KR_7769156234,840.278,14.0,49236,48425,811
KR_7769156234,900.279,15.0,52830,51134,1696
KR_7769156234,960.309,16.01,56326,55463,863
KR_7769156234,1020.331,17.01,58957,57628,1329
KR_7769156234,1080.356,18.01,61656,60421,1235
KR_7769156234,1140.362,19.01,65972,62675,3297
KR_7769156234,1200.395,20.01,70636,65492,5144
KR_7769156234,1260.426,21.01,72777,69912,2865
KR_7769156234,1303.565,21.73,76025,71423,4602
KR_7751475746,0.0,0.0,7000,7000,0
KR_7751475746,60.011,1.0,7015,7437,-422
KR_7751475746,120.034,2.0,11392,12170,-778
KR_7751475746,180.122,3.0,15291,15146,145
KR_7751475746,240.151,4.0,19535,18888,647
KR_7751475746,300.167,5.0,23380,21825,1555
KR_7751475746,360.192,6.0,27120,26095,1025
KR_7751475746,420.221,7.0,31848,28712,3136
KR_7751475746,480.225,8.0,33894,34141,-247
KR_7751475746,540.229,9.0,37411,37741,-330
KR_7751475746,600.257,10.0,41480,40597,883
KR_7751475746,660.262,11.0,43676,44558,-882
KR_7751475746,720.289,12.0,47419,47466,-47
KR_7751475746,780.289,13.0,50030,50767,-737
KR_7751475746,840.319,14.01,52728,54506,-1778
KR_7751475746,900.343,15.01,56961,57514,-553
KR_7751475746,960.371,16.01,59122,61127,-2005
KR_7751475746,964.313,16.07,59242,61247,-2005
KR_7779274502,0.0,0.0,7000,7000,0
KR_7779274502,60.016,1.0,7487,7015,472
KR_7779274502,120.042,2.0,9735,10423,-688
KR_7779274502,180.105,3.0,12935,14120,-1185
KR_7779274502,240.126,4.0,15385,16560,-1175
KR_7779274502,300.145,5.0,19515,20280,-765
KR_7779274502,360.166,6.0,22039,22974,-935
KR_7779274502,420.177,7.0,26696,26803,-107
KR_7779274502,480.203,8.0,28804,29664,-860
KR_7779274502,540.21,9.0,32882,33279,-397
KR_7779274502,600.23,10.0,36000,36015,-15
KR_7779274502,660.255,11.0,38716,39796,-1080
KR_7779274502,720.266,12.0,41846,42054,-208
KR_7779274502,780.283,13.0,46218,45292,926
KR_7779274502,840.307,14.01,48471,49497,-1026
KR_7779274502,900.322,15.01,50625,52306,-1681
KR_7779274502,960.325,16.01,54413,54995,-582
KR_7779274502,1020.352,17.01,56618,58104,-1486
KR_7779274502,1080.356,18.01,58727,62514,-3787
KR_7779274502,1140.377,19.01,62812,66155,-3343
KR_7779274502,1200.401,20.01,65464,68745,-3281
KR_7779274502,1258.865,20.98,67601,72467,-4866
KR_7724237475,0.0,0.0,7000,7000,0
KR_7724237475,60.018,1.0,8592,8315,277
KR_7724237475,120.048,2.0,11226,11118,108
KR_7724237475,180.14,3.0,13461,14827,-1366
KR_7724237475,240.17,4.0,19240,17362,1878
KR_7724237475,300.189,5.0,22087,20797,1290
KR_7724237475,360.211,6.0,25564,25175,389
KR_7724237475,420.22,7.0,28581,27442,1139
KR_7724237475,480.246,8.0,31892,31701,191
KR_7724237475,540.267,9.0,34845,34269,576
KR_7724237475,600.298,10.0,37388,37787,-399
KR_7724237475,660.305,11.01,39791,42568,-2777
KR_7724237475,720.307,12.01,43686,45564,-1878
KR_7724237475,780.323,13.01,46459,48331,-1872
KR_7724237475,840.345,14.01,49078,52904,-3826
KR_7724237475,900.363,15.01,53012,55661,-2649
KR_7724237475,960.385,16.01,57418,57803,-385
KR_7724237475,1020.389,17.01,59825,63248,-3423
KR_7724237475,1080.412,18.01,64156,65087,-931
KR_7724237475,1140.441,19.01,67714,68756,-1042
KR_7724237475,1200.446,20.01,71297,71306,-9
KR_7724237475,1260.448,21.01,74672,75172,-500
KR_7724237475,1320.45,22.01,78201,77787,414
KR_7724237475,1348.34,22.47,80343,79178,1165
KR_7742345858,0.0,0.0,7000,7000,0
KR_7742345858,60.033,1.0,7015,7015,0
KR_7742345858,120.038,2.0,9303,10601,-1298
KR_7742345858,180.058,3.0,12174,13395,-1221
KR_7742345858,240.066,4.0,15809,17467,-1658
KR_7742345858,300.146,5.0,19012,20388,-1376
KR_7742345858,360.176,6.0,22596,24036,-1440
KR_7742345858,420.18,7.0,26414,27189,-775
KR_7742345858,480.182,8.0,29629,31024,-1395
KR_7742345858,540.189,9.0,32790,34545,-1755
KR_7742345858,600.208,10.0,36305,37120,-815
KR_7742345858,660.224,11.0,39290,40467,-1177
KR_7742345858,720.239,12.0,42086,44065,-1979
KR_7742345858,780.256,13.0,44855,47835,-2980
KR_7742345858,840.284,14.0,48070,51461,-3391
KR_7742345858,900.295,15.0,51187,54183,-2996
KR_7742345858,960.319,16.01,53666,57107,-3441
KR_7742345858,1020.324,17.01,56403,60147,-3744
KR_7742345858,1080.356,18.01,59189,62814,-3625
KR_7742345858,1140.377,19.01,63065,66310,-3245
KR_7742345858,1200.378,20.01,65818,69254,-3436
KR_7742345858,1260.403,21.01,68242,73808,-5566
KR_7742345858,1320.41,22.01,71141,76823,-5682
KR_7742345858,1380.415,23.01,75289,79941,-4652
KR_7742345858,1440.425,24.01,78093,83608,-5515
KR_7742345858,1500.436,25.01,81674,88116,-6442
KR_7742345858,1560.461,26.01,84614,91088,-6474
KR_7742345858,1593.554,26.56,85905,92831,-6926
KR_7776875054,0.0,0.0,7000,7000,0
KR_7776875054,60.031,1.0,7829,7813,16
KR_7776875054,120.044,2.0,10491,10521,-30
KR_7776875054,180.132,3.0,14639,15128,-489
KR_7776875054,240.153,4.0,17915,18786,-871
KR_7776875054,300.163,5.0,21563,21162,401
KR_7776875054,360.182,6.0,23677,26477,-2800
KR_7776875054,420.212,7.0,27071,28868,-1797
KR_7776875054,480.23,8.0,30317,31762,-1445
KR_7776875054,540.24,9.0,33720,35510,-1790
KR_7776875054,600.259,10.0,36907,38665,-1758
KR_7776875054,660.28,11.0,39296,41043,-1747
KR_7776875054,720.306,12.01,43088,45679,-2591
KR_7776875054,780.338,13.01,46070,48075,-2005
KR_7776875054,840.357,14.01,48575,51934,-3359
KR_7776875054,900.373,15.01,52586,56047,-3461
KR_7776875054,960.393,16.01,56880,59205,-2325
KR_7776875054,1020.394,17.01,60677,61745,-1068
KR_7776875054,1080.412,18.01,63176,64290,-1114
KR_7776875054,1140.421,19.01,66318,69017,-2699
KR_7776875054,1200.423,20.01,69111,71338,-2227
KR_7776875054,1260.438,21.01,71621,74992,-3371
KR_7776875054,1320.461,22.01,74348,77667,-3319
KR_7776875054,1380.482,23.01,80322,80764,-442
KR_7776875054,1385.325,23.09,80472,80949,-477
KR_7779608915,0.0,0.0,7000,7000,0
KR_7779608915,60.024,1.0,7015,7795,-780
KR_7779608915,120.033,2.0,10537,10979,-442
KR_7779608915,180.125,3.0,13415,13928,-513
KR_7779608915,240.148,4.0,17441,17586,-145
KR_7779608915,300.16,5.0,20795,20132,663
KR_7779608915,360.167,6.0,23918,24260,-342
KR_7779608915,420.198,7.0,27187,27747,-560
KR_7779608915,480.227,8.0,29540,31296,-1756
KR_7779608915,540.255,9.0,34089,34940,-851
KR_7779608915,600.279,10.0,38467,37793,674
KR_7779608915,660.283,11.0,40721,42467,-1746
KR_7779608915,720.286,12.0,46163,44513,1650
KR_7779608915,780.307,13.01,48907,48520,387
KR_7779608915,840.308,14.01,52809,51722,1087
KR_7779608915,900.335,15.01,55616,54510,1106
KR_7779608915,960.347,16.01,59575,57845,1730
KR_7779608915,1020.371,17.01,62596,60598,1998
KR_7779608915,1080.378,18.01,66109,63079,3030
KR_7779608915,1140.383,19.01,68894,66254,2640
KR_7779608915,1200.403,20.01,72074,68720,3354
KR_7779608915,1260.436,21.01,75464,71530,3934
KR_7779608915,1320.448,22.01,80329,74683,5646
KR_7779608915,1380.461,23.01,82326,78530,3796
KR_7779608915,1440.473,24.01,88071,80558,7513
KR_7779608915,1441.642,24.03,88116,80603,7513
KR_7775231130,0.0,0.0,7000,7000,0
KR_7775231130,60.009,1.0,7310,7725,-415
KR_7775231130,120.027,2.0,10694,12183,-1489
KR_7775231130,180.123,3.0,14728,15488,-760
KR_7775231130,240.148,4.0,18519,18600,-81
KR_7775231130,300.162,5.0,20709,22035,-1326
KR_7775231130,360.186,6.0,24172,25567,-1395
KR_7775231130,420.219,7.0,28067,29097,-1030
KR_7775231130,480.239,8.0,31409,32284,-875
KR_7775231130,540.26,9.0,35552,35606,-54
KR_7775231130,600.264,10.0,38446,39282,-836
KR_7775231130,660.27,11.0,41268,42346,-1078
KR_7775231130,720.29,12.0,45008,45496,-488
KR_7775231130,780.318,13.01,48757,48719,38
KR_7775231130,840.346,14.01,51220,51074,146
KR_7775231130,900.353,15.01,54788,54782,6
KR_7775231130,960.385,16.01,57208,58867,-1659
KR_7775231130,1020.41,17.01,60037,62125,-2088
KR_7775231130,1080.415,18.01,62638,65010,-2372
KR_7775231130,1140.445,19.01,67723,67701,22
KR_7775231130,1200.473,20.01,70973,70941,32
KR_7775231130,1260.487,21.01,75523,73551,1972
KR_7775231130,1265.832,21.1,75688,73716,1972
KR_7776977190,0.0,0.0,7000,7000,0
KR_7776977190,60.023,1.0,7468,7765,-297
KR_7776977190,120.056,2.0,11415,11187,228
KR_7776977190,180.142,3.0,14101,13919,182
KR_7776977190,240.171,4.0,17637,17875,-238
KR_7776977190,300.204,5.0,21564,20831,733
KR_7776977190,360.233,6.0,24629,24172,457
KR_7776977190,420.24,7.0,27881,27053,828
KR_7776977190,480.264,8.0,31029,32094,-1065
KR_7776977190,540.297,9.0,34732,35156,-424
KR_7776977190,600.299,10.0,38044,38455,-411
KR_7776977190,660.301,11.01,40766,41144,-378
KR_7776977190,720.327,12.01,44780,43998,782
KR_7776977190,780.331,13.01,48997,48252,745
KR_7776977190,840.35,14.01,51945,50453,1492
KR_7776977190,900.368,15.01,55567,53960,1607
KR_7776977190,960.372,16.01,58238,57182,1056
KR_7776977190,1020.38,17.01,61894,61052,842
KR_7776977190,1080.39,18.01,65386,64204,1182
KR_7776977190,1140.41,19.01,68885,68742,143
KR_7776977190,1200.411,20.01,71515,71040,475
KR_7776977190,1260.427,21.01,74138,74966,-828
KR_7776977190,1281.436,21.36,74768,76958,-2190
KR_7740236069,0.0,0.0,7000,7000,0
KR_7740236069,60.01,1.0,7015,7015,0
KR_7740236069,120.022,2.0,9639,10568,-929
KR_7740236069,180.04,3.0,13816,14039,-223
KR_7740236069,240.055,4.0,16993,16688,305
KR_7740236069,300.073,5.0,20961,20517,444
KR_7740236069,360.098,6.0,23172,23873,-701
KR_7740236069,420.173,7.0,26780,26252,528
KR_7740236069,480.189,8.0,29768,29356,412
KR_7740236069,540.201,9.0,33278,32093,1185
KR_7740236069,600.221,10.0,37460,36251,1209
KR_7740236069,660.249,11.0,40916,38481,2435
KR_7740236069,720.264,12.0,44305,41587,2718
KR_7740236069,780.284,13.0,47720,44764,2956
KR_7740236069,840.296,14.0,50448,49099,1349
KR_7740236069,900.302,15.01,55008,51778,3230
KR_7740236069,960.326,16.01,58486,54480,4006
KR_7740236069,1020.337,17.01,63859,56985,6874
KR_7740236069,1021.406,17.02,63889,57015,6874
KR_7734384136,0.0,0.0,7000,7000,0
KR_7734384136,60.01,1.0,7528,7487,41
KR_7734384136,120.032,2.0,11362,11151,211
KR_7734384136,180.129,3.0,14651,15235,-584
KR_7734384136,240.148,4.0,18301,18622,-321
KR_7734384136,300.177,5.0,21850,21647,203
KR_7734384136,360.203,6.0,25767,25418,349
KR_7734384136,420.218,7.0,29239,28568,671
KR_7734384136,480.238,8.0,31807,31501,306
KR_7734384136,540.252,9.0,35136,34734,402
KR_7734384136,600.269,10.0,38941,37737,1204
KR_7734384136,660.288,11.0,43016,41655,1361
KR_7734384136,720.317,12.01,46098,44322,1776
KR_7734384136,780.322,13.01,48635,47987,648
KR_7734384136,840.351,14.01,52006,51466,540
KR_7734384136,900.366,15.01,54587,55142,-555
KR_7734384136,960.39,16.01,57433,59031,-1598
KR_7734384136,1020.409,17.01,61054,62374,-1320
KR_7734384136,1080.412,18.01,63734,66402,-2668
KR_7734384136,1140.424,19.01,68027,69169,-1142
KR_7734384136,1192.963,19.88,69922,73533,-3611
KR_7773440903,0.0,0.0,7000,7000,0
KR_7773440903,60.005,1.0,7015,7015,0
KR_7773440903,120.03,2.0,9872,9965,-93
KR_7773440903,180.111,3.0,13713,13726,-13
KR_7773440903,240.135,4.0,16560,16801,-241
KR_7773440903,300.164,5.0,19846,19401,445
KR_7773440903,360.186,6.0,23081,22504,577
KR_7773440903,420.207,7.0,27747,26201,1546
KR_7773440903,480.229,8.0,30864,29546,1318
KR_7773440903,540.232,9.0,33975,32336,1639
KR_7773440903,600.253,10.0,37184,35357,1827
KR_7773440903,660.28,11.0,40327,39150,1177
KR_7773440903,720.303,12.01,43057,42284,773
KR_7773440903,780.309,13.01,46498,45792,706
KR_7773440903,840.33,14.01,49542,50158,-616
KR_7773440903,900.34,15.01,51932,52822,-890
KR_7773440903,960.359,16.01,55747,58314,-2567
KR_7773440903,1020.367,17.01,59105,60581,-1476
KR_7773440903,1080.384,18.01,62877,64112,-1235
KR_7773440903,1140.397,19.01,66357,66631,-274
KR_7773440903,1200.425,20.01,69074,69561,-487
KR_7773440903,1240.51,20.68,70320,72446,-2126
KR_7753165704,0.0,0.0,7000,7000,0
KR_7753165704,60.02,1.0,7015,7015,0
KR_7753165704,120.046,2.0,9830,9533,297
KR_7753165704,180.127,3.0,13781,12876,905
KR_7753165704,240.154,4.0,17505,15109,2396
KR_7753165704,300.17,5.0,21571,19353,2218
KR_7753165704,360.196,6.0,24985,22037,2948
KR_7753165704,420.216,7.0,27684,25382,2302
KR_7753165704,480.237,8.0,31572,29127,2445
KR_7753165704,540.252,9.0,34685,32037,2648
KR_7753165704,600.282,10.0,37821,34537,3284
KR_7753165704,660.297,11.0,40655,39275,1380
KR_7753165704,720.316,12.01,44591,41917,2674
KR_7753165704,780.345,13.01,49412,45469,3943
KR_7753165704,840.374,14.01,52320,49212,3108
KR_7753165704,900.398,15.01,56097,51668,4429
KR_7753165704,960.423,16.01,59675,54898,4777
KR_7753165704,1020.441,17.01,62335,58092,4243
KR_7753165704,1080.468,18.01,66105,61861,4244
KR_7753165704,1140.485,19.01,68820,66962,1858
KR_7753165704,1200.499,20.01,72683,69552,3131
KR_7753165704,1260.529,21.01,75016,72374,2642
KR_7753165704,1320.53,22.01,77934,74946,2988
KR_7753165704,1378.723,22.98,81004,78759,2245
KR_7773179421,0.0,0.0,7000,7000,0
KR_7773179421,60.007,1.0,7015,7015,0
KR_7773179421,120.04,2.0,9315,9341,-26
KR_7773179421,180.113,3.0,11803,12876,-1073
KR_7773179421,240.126,4.0,13884,17180,-3296
KR_7773179421,300.129,5.0,18709,20052,-1343
KR_7773179421,360.155,6.0,21612,22785,-1173
KR_7773179421,420.187,7.0,24082,27998,-3916
KR_7773179421,480.219,8.0,26686,30308,-3622
KR_7773179421,540.229,9.0,31564,33135,-1571
KR_7773179421,600.257,10.0,34938,36258,-1320
KR_7773179421,660.261,11.0,37483,41224,-3741
KR_7773179421,720.27,12.0,40447,43572,-3125
KR_7773179421,780.293,13.0,44502,46201,-1699
KR_7773179421,840.31,14.01,47452,50886,-3434
KR_7773179421,900.331,15.01,50803,54819,-4016
KR_7773179421,960.357,16.01,54428,57829,-3401
KR_7773179421,1020.391,17.01,57462,61011,-3549
KR_7773179421,1031.481,17.19,57792,62092,-4300
KR_7742415871,0.0,0.0,7000,7000,0
KR_7742415871,60.017,1.0,7765,7387,378
KR_7742415871,120.019,2.0,11134,10607,527
KR_7742415871,180.037,3.0,14878,14552,326
KR_7742415871,240.048,4.0,17389,18817,-1428
KR_7742415871,300.066,5.0,21676,23032,-1356
KR_7742415871,360.087,6.0,24427,26303,-1876
KR_7742415871,420.167,7.0,27373,29504,-2131
KR_7742415871,480.185,8.0,31015,32847,-1832
KR_7742415871,540.209,9.0,33504,37217,-3713
KR_7742415871,600.238,10.0,38517,40000,-1483
KR_7742415871,660.265,11.0,40489,44328,-3839
KR_7742415871,720.291,12.0,43532,47418,-3886
KR_7742415871,780.297,13.0,45682,50912,-5230
KR_7742415871,840.302,14.01,49450,54931,-5481
KR_7742415871,900.314,15.01,52152,58581,-6429
KR_7742415871,960.341,16.01,55237,61179,-5942
KR_7742415871,1020.374,17.01,58083,65226,-7143
KR_7742415871,1080.384,18.01,61436,68460,-7024
KR_7742415871,1140.415,19.01,64892,71185,-6293
KR_7742415871,1200.42,20.01,68181,75107,-6926
KR_7742415871,1237.461,20.62,69422,76350,-6928
KR_7772067605,0.0,0.0,7000,7000,0
KR_7772067605,60.014,1.0,7015,7015,0
KR_7772067605,120.021,2.0,9996,9288,708
KR_7772067605,180.037,3.0,12632,13241,-609
KR_7772067605,240.04,4.0,16577,16879,-302
KR_7772067605,300.06,5.0,20752,20326,426
KR_7772067605,360.079,6.0,23206,23212,-6
KR_7772067605,420.08,7.0,28360,25756,2604
KR_7772067605,480.097,8.0,32026,29070,2956
KR_7772067605,540.177,9.0,35780,32899,2881
KR_7772067605,600.207,10.0,38532,35430,3102
KR_7772067605,660.234,11.0,42539,39236,3303
KR_7772067605,720.266,12.0,45293,43101,2192
KR_7772067605,780.299,13.0,49475,45890,3585
KR_7772067605,840.319,14.01,52741,50359,2382
KR_7772067605,900.321,15.01,56118,53137,2981
KR_7772067605,960.326,16.01,59455,56089,3366
KR_7772067605,1020.327,17.01,61969,58873,3096
KR_7772067605,1080.357,18.01,67093,62796,4297
KR_7772067605,1140.358,19.01,70336,66179,4157
KR_7772067605,1200.361,20.01,72724,69493,3231
KR_7772067605,1260.364,21.01,76057,71857,4200
KR_7772067605,1284.686,21.41,77393,72889,4504
KR_7756740777,0.0,0.0,7000,7000,0
KR_7756740777,60.008,1.0,7015,7443,-428
KR_7756740777,120.029,2.0,9900,10771,-871
KR_7756740777,180.111,3.0,12234,13966,-1732
KR_7756740777,240.137,4.0,17515,17654,-139
KR_7756740777,300.156,5.0,20167,20784,-617
KR_7756740777,360.177,6.0,23274,24533,-1259
KR_7756740777,420.182,7.0,27603,28482,-879
KR_7756740777,480.208,8.0,30741,31561,-820
KR_7756740777,540.222,9.0,33399,34068,-669
KR_7756740777,600.25,10.0,37515,38804,-1289
KR_7756740777,660.273,11.0,40509,41796,-1287
KR_7756740777,720.299,12.0,44177,46237,-2060
KR_7756740777,780.311,13.01,49181,48981,200
KR_7756740777,840.342,14.01,52085,53160,-1075
KR_7756740777,900.368,15.01,55531,55230,301
KR_7756740777,960.375,16.01,59972,58786,1186
KR_7756740777,1020.385,17.01,62235,61969,266
KR_7756740777,1080.408,18.01,66087,65857,230
KR_7756740777,1140.431,19.01,69600,69541,59
KR_7756740777,1200.442,20.01,72188,73258,-1070
KR_7756740777,1209.494,20.16,72458,73964,-1506
KR_7777224462,0.0,0.0,7000,7000,0
KR_7777224462,60.009,1.0,7497,7015,482
KR_7777224462,120.021,2.0,10432,10565,-133
KR_7777224462,180.034,3.0,13497,13782,-285
KR_7777224462,240.045,4.0,16798,16451,347
KR_7777224462,300.06,5.0,20367,20336,31
KR_7777224462,360.06,6.0,25666,24021,1645
KR_7777224462,420.073,7.0,28291,26337,1954
KR_7777224462,480.078,8.0,32349,29140,3209
KR_7777224462,540.091,9.0,36492,32739,3753
KR_7777224462,600.097,10.0,38942,35110,3832
KR_7777224462,660.108,11.0,44252,38131,6121
KR_7777224462,685.123,11.42,45503,38888,6615
KR_7773060135,0.0,0.0,7000,7000,0
KR_7773060135,60.01,1.0,7015,7015,0
KR_7773060135,120.042,2.0,9304,9341,-37
KR_7773060135,180.104,3.0,12776,11797,979
KR_7773060135,240.113,4.0,14985,15152,-167
KR_7773060135,300.128,5.0,19141,18494,647
KR_7773060135,360.153,6.0,21388,21272,116
KR_7773060135,420.164,7.0,24928,25116,-188
KR_7773060135,480.189,8.0,27873,27652,221
KR_7773060135,540.207,9.0,30225,30027,198
KR_7773060135,600.212,10.0,33124,33411,-287
KR_7773060135,660.237,11.0,36173,36132,41
KR_7773060135,720.254,12.0,38546,40482,-1936
KR_7773060135,780.275,13.0,42311,42737,-426
KR_7773060135,840.29,14.0,44779,45219,-440
KR_7773060135,900.315,15.01,48388,49050,-662
KR_7773060135,960.338,16.01,50623,53944,-3321
KR_7773060135,1020.363,17.01,53674,56381,-2707
KR_7773060135,1080.38,18.01,57392,59249,-1857
KR_7773060135,1140.406,19.01,60525,63032,-2507
KR_7773060135,1200.414,20.01,64107,66938,-2831
KR_7773060135,1209.934,20.17,64392,67223,-2831
KR_7778740365,0.0,0.0,7000,7000,0
KR_7778740365,60.013,1.0,8202,8226,-24
KR_7778740365,120.037,2.0,12313,11718,595
KR_7778740365,180.127,3.0,14779,15558,-779
KR_7778740365,240.148,4.0,19307,18697,610
KR_7778740365,300.164,5.0,23021,22596,425
KR_7778740365,360.169,6.0,25944,25732,212
KR_7778740365,420.192,7.0,29498,30777,-1279
KR_7778740365,480.211,8.0,32420,33142,-722
KR_7778740365,540.235,9.0,35603,36896,-1293
KR_7778740365,600.26,10.0,38393,39368,-975
KR_7778740365,660.293,11.0,41646,42068,-422
KR_7778740365,720.312,12.01,45468,44795,673
KR_7778740365,780.322,13.01,49052,48368,684
KR_7778740365,840.328,14.01,51850,51215,635
KR_7778740365,900.337,15.01,56154,54389,1765
KR_7778740365,960.368,16.01,59424,57849,1575
KR_7778740365,1020.391,17.01,62873,61043,1830
KR_7778740365,1080.392,18.01,66831,63566,3265
KR_7778740365,1140.397,19.01,70518,66188,4330
KR_7778740365,1200.405,20.01,73911,69299,4612
KR_7778740365,1260.433,21.01,76207,72915,3292
KR_7778740365,1320.462,22.01,79837,75154,4683
KR_7778740365,1329.68,22.16,80496,75439,5057
KR_7706429977,0.0,0.0,7000,7000,0
KR_7706429977,60.032,1.0,7015,7015,0
KR_7706429977,120.06,2.0,9268,9833,-565
KR_7706429977,180.147,3.0,13650,12929,721
KR_7706429977,240.171,4.0,16224,16714,-490
KR_7706429977,300.195,5.0,20494,21022,-528
KR_7706429977,360.204,6.0,23877,25568,-1691
KR_7706429977,420.221,7.0,27389,30066,-2677
KR_7706429977,480.243,8.0,31151,33523,-2372
KR_7706429977,540.256,9.0,33705,36342,-2637
KR_7706429977,600.281,10.0,36295,39897,-3602
KR_7706429977,660.296,11.0,38624,42785,-4161
KR_7706429977,720.32,12.01,42307,47083,-4776
KR_7706429977,780.346,13.01,44731,50457,-5726
KR_7706429977,840.386,14.01,47812,52633,-4821
KR_7706429977,900.399,15.01,50226,58390,-8164
KR_7706429977,915.529,15.26,51386,59348,-7962
KR_7778328631,0.0,0.0,7000,7000,0
KR_7778328631,60.02,1.0,7015,7015,0
KR_7778328631,120.025,2.0,9757,9974,-217
KR_7778328631,180.033,3.0,12541,13342,-801
KR_7778328631,240.043,4.0,15007,16662,-1655
KR_7778328631,300.142,5.0,19949,19846,103
KR_7778328631,360.157,6.0,22135,24555,-2420
KR_7778328631,420.182,7.0,25192,27002,-1810
KR_7778328631,480.185,8.0,29236,30832,-1596
KR_7778328631,540.208,9.0,34057,33818,239
KR_7778328631,600.238,10.0,36639,37536,-897
KR_7778328631,660.242,11.0,40876,41027,-151
KR_7778328631,720.259,12.0,43748,43952,-204
KR_7778328631,780.26,13.0,46656,47711,-1055
KR_7778328631,840.281,14.0,50292,50851,-559
KR_7778328631,900.283,15.0,53181,53981,-800
KR_7778328631,960.297,16.0,56136,57537,-1401
KR_7778328631,1020.329,17.01,60463,59808,655
KR_7778328631,1080.349,18.01,63671,62615,1056
KR_7778328631,1140.372,19.01,66114,67257,-1143
KR_7778328631,1153.706,19.23,66822,68747,-1925
KR_7753275282,0.0,0.0,7000,7000,0
KR_7753275282,60.015,1.0,7273,7627,-354
KR_7753275282,120.024,2.0,10635,10620,15
KR_7753275282,180.042,3.0,13659,13470,189
KR_7753275282,240.05,4.0,16686,17237,-551
KR_7753275282,300.12,5.0,19874,21228,-1354
KR_7753275282,360.142,6.0,24011,25004,-993
KR_7753275282,420.143,7.0,28207,28493,-286
KR_7753275282,480.172,8.0,32019,32294,-275
KR_7753275282,540.193,9.0,34980,35513,-533
KR_7753275282,600.21,10.0,37758,38635,-877
KR_7753275282,660.227,11.0,41079,41863,-784
KR_7753275282,720.253,12.0,43855,45090,-1235
KR_7753275282,780.254,13.0,47305,48043,-738
KR_7753275282,840.274,14.0,49510,52778,-3268
KR_7753275282,900.281,15.0,54399,55771,-1372
KR_7753275282,960.303,16.01,56578,59241,-2663
KR_7753275282,1020.331,17.01,60337,62144,-1807
KR_7753275282,1080.344,18.01,62811,65589,-2778
KR_7753275282,1140.361,19.01,65545,69940,-4395
KR_7753275282,1200.377,20.01,69858,73871,-4013
KR_7753275282,1260.395,21.01,72225,77338,-5113
KR_7753275282,1317.598,21.96,74201,81959,-7758
KR_7773302770,0.0,0.0,7000,7000,0
KR_7773302770,60.009,1.0,7015,7015,0
KR_7773302770,120.036,2.0,10967,11564,-597
KR_7773302770,180.129,3.0,13793,14602,-809
KR_7773302770,240.136,4.0,17922,17876,46
KR_7773302770,300.164,5.0,20856,20257,599
KR_7773302770,360.195,6.0,24056,23232,824
KR_7773302770,420.227,7.0,27728,27181,547
KR_7773302770,480.235,8.0,31126,29521,1605
KR_7773302770,540.243,9.0,34519,34110,409
KR_7773302770,600.269,10.0,38294,37542,752
KR_7773302770,660.292,11.0,41234,40797,437
KR_7773302770,720.324,12.01,45205,43722,1483
KR_7773302770,780.326,13.01,48487,46805,1682
KR_7773302770,840.356,14.01,52000,51065,935
KR_7773302770,900.374,15.01,55137,54756,381
KR_7773302770,960.393,16.01,58379,57417,962
KR_7773302770,1020.397,17.01,61857,59937,1920
KR_7773302770,1080.41,18.01,67779,62761,5018
KR_7773302770,1140.442,19.01,70210,65605,4605
KR_7773302770,1200.46,20.01,73728,67928,5800
KR_7773302770,1204.569,20.08,73898,68048,5850
KR_7778505222,0.0,0.0,7000,7000,0
KR_7778505222,60.003,1.0,7015,7025,-10
KR_7778505222,120.035,2.0,9340,9366,-26
KR_7778505222,180.117,3.0,11780,11880,-100
KR_7778505222,240.145,4.0,15511,16504,-993
KR_7778505222,300.149,5.0,18944,20110,-1166
KR_7778505222,360.178,6.0,21508,23003,-1495
KR_7778505222,420.189,7.0,26060,27006,-946
KR_7778505222,480.214,8.0,28700,29847,-1147
KR_7778505222,540.229,9.0,31875,33373,-1498
KR_7778505222,600.229,10.0,35583,36390,-807
KR_7778505222,660.253,11.0,38510,39202,-692
KR_7778505222,720.273,12.0,42120,44089,-1969
KR_7778505222,780.277,13.0,45530,47036,-1506
KR_7778505222,840.305,14.01,48533,49850,-1317
KR_7778505222,900.31,15.01,51107,52613,-1506
KR_7778505222,960.312,16.01,53943,55871,-1928
KR_7778505222,1020.32,17.01,56951,59843,-2892
KR_7778505222,1080.346,18.01,60964,62620,-1656
KR_7778505222,1140.368,19.01,65174,66015,-841
KR_7778505222,1200.379,20.01,67550,68493,-943
KR_7778505222,1260.396,21.01,71254,73124,-1870
KR_7778505222,1320.403,22.01,74312,75633,-1321
KR_7778505222,1380.417,23.01,77966,78276,-310
KR_7778505222,1440.42,24.01,81505,80915,590
KR_7778505222,1500.426,25.01,84452,86074,-1622
KR_7778505222,1560.445,26.01,88353,88340,13
KR_7778505222,1592.212,26.54,90924,89300,1624
KR_7743783325,0.0,0.0,7000,7000,0
KR_7743783325,60.005,1.0,7015,7015,0
KR_7743783325,120.023,2.0,9625,10477,-852
KR_7743783325,180.112,3.0,12462,12876,-414
KR_7743783325,240.116,4.0,16056,16726,-670
KR_7743783325,300.133,5.0,19457,20861,-1404
KR_7743783325,360.136,6.0,22448,23649,-1201
KR_7743783325,420.164,7.0,26170,26691,-521
KR_7743783325,480.191,8.0,28779,30518,-1739
KR_7743783325,492.282,8.2,29678,31628,-1950
KR_7769948037,0.0,0.0,7000,7000,0
KR_7769948037,60.019,1.0,7015,7015,0
KR_7769948037,120.04,2.0,9312,9703,-391
KR_7769948037,180.129,3.0,12154,12855,-701
KR_7769948037,240.155,4.0,14637,15943,-1306
KR_7769948037,300.174,5.0,19169,19560,-391
KR_7769948037,360.179,6.0,21387,23465,-2078
KR_7769948037,420.203,7.0,25234,26984,-1750
KR_7769948037,480.212,8.0,27588,30963,-3375
KR_7769948037,540.215,9.0,31968,34093,-2125
KR_7769948037,600.238,10.0,34966,37886,-2920
KR_7769948037,660.26,11.0,37953,40474,-2521
KR_7769948037,696.103,11.6,39018,43457,-4439
KR_7774967593,0.0,0.0,7000,7000,0
KR_7774967593,60.005,1.0,8122,7674,448
KR_7774967593,120.029,2.0,11094,10998,96
KR_7774967593,180.11,3.0,13981,14848,-867
KR_7774967593,240.13,4.0,17362,17121,241
KR_7774967593,300.162,5.0,20247,20659,-412
KR_7774967593,360.163,6.0,23638,24130,-492
KR_7774967593,420.185,7.0,27342,26599,743
KR_7774967593,480.216,8.0,30450,30118,332
KR_7774967593,540.248,9.0,33355,35303,-1948
KR_7774967593,600.261,10.0,35996,38437,-2441
KR_7774967593,660.281,11.0,40351,41481,-1130
KR_7774967593,720.291,12.0,42644,46186,-3542
KR_7774967593,780.316,13.01,45300,48767,-3467
KR_7774967593,840.324,14.01,50314,51647,-1333
KR_7774967593,900.356,15.01,52793,54726,-1933
KR_7774967593,960.371,16.01,55645,59924,-4279
KR_7774967593,962.81,16.05,55720,59999,-4279
KR_7644858733,0.0,0.0,7000,7000,0
KR_7644858733,60.006,1.0,7445,7830,-385
KR_7644858733,120.038,2.0,10074,11420,-1346
KR_7644858733,180.096,3.0,13369,13879,-510
KR_7644858733,240.122,4.0,15748,16294,-546
KR_7644858733,300.142,5.0,19900,20141,-241
KR_7644858733,360.154,6.0,23077,23097,-20
KR_7644858733,420.186,7.0,28309,25452,2857
KR_7644858733,480.198,8.0,30833,28873,1960
KR_7644858733,540.225,9.0,33405,31421,1984
KR_7644858733,600.23,10.0,36860,35459,1401
KR_7644858733,660.231,11.0,40344,37856,2488
KR_7644858733,720.262,12.0,42968,40798,2170
KR_7644858733,780.292,13.0,45593,44840,753
KR_7644858733,840.303,14.01,49350,47816,1534
KR_7644858733,900.305,15.01,51800,50618,1182
KR_7644858733,960.313,16.01,54513,53386,1127
KR_7644858733,1020.344,17.01,57307,57274,33
KR_7644858733,1080.347,18.01,59863,60396,-533
KR_7644858733,1140.362,19.01,63146,63855,-709
KR_7644858733,1200.373,20.01,65544,67471,-1927
KR_7644858733,1260.386,21.01,70034,70221,-187
KR_7644858733,1320.415,22.01,73789,74096,-307
KR_7644858733,1380.418,23.01,77095,76563,532
KR_7644858733,1440.435,24.01,80822,79733,1089
KR_7644858733,1469.43,24.49,83598,80620,2978
KR_7767559152,0.0,0.0,7000,7000,0
KR_7767559152,60.03,1.0,7459,7015,444
KR_7767559152,120.059,2.0,10666,10435,231
KR_7767559152,180.139,3.0,13429,13255,174
KR_7767559152,240.161,4.0,17777,17774,3
KR_7767559152,300.193,5.0,21260,21722,-462
KR_7767559152,360.195,6.0,24115,25471,-1356
KR_7767559152,420.221,7.0,26884,28249,-1365
KR_7767559152,480.254,8.0,30488,31923,-1435
KR_7767559152,540.266,9.0,33896,34551,-655
KR_7767559152,600.28,10.0,37213,39397,-2184
KR_7767559152,660.308,11.01,39906,41662,-1756
KR_7767559152,720.337,12.01,43608,45693,-2085
KR_7767559152,780.351,13.01,48553,48652,-99
KR_7767559152,840.37,14.01,51106,51370,-264
KR_7767559152,900.4,15.01,54494,54422,72
KR_7767559152,960.421,16.01,57688,57464,224
KR_7767559152,1020.426,17.01,60345,62058,-1713
KR_7767559152,1080.429,18.01,62891,64349,-1458
KR_7767559152,1140.461,19.01,65936,66957,-1021
KR_7767559152,1200.465,20.01,68901,69639,-738
KR_7767559152,1260.466,21.01,71504,74842,-3338
KR_7767559152,1288.257,21.47,72537,76784,-4247
KR_7740286284,0.0,0.0,7000,7000,0
KR_7740286284,60.007,1.0,9157,8129,1028
KR_7740286284,120.037,2.0,12739,10780,1959
KR_7740286284,180.113,3.0,15793,13937,1856
KR_7740286284,240.131,4.0,19385,18457,928
KR_7740286284,300.15,5.0,24809,21606,3203
KR_7740286284,360.182,6.0,29257,25458,3799
KR_7740286284,420.185,7.0,32633,28608,4025
KR_7740286284,480.204,8.0,36112,31861,4251
KR_7740286284,540.217,9.0,39508,35666,3842
KR_7740286284,600.237,10.0,42890,38104,4786
KR_7740286284,660.238,11.0,45992,42982,3010
KR_7740286284,720.258,12.0,50369,46707,3662
KR_7740286284,780.258,13.0,53230,49000,4230
KR_7740286284,840.273,14.0,56860,51825,5035
KR_7740286284,900.287,15.0,61026,54100,6926
KR_7740286284,935.76,15.6,63332,56362,6970
KR_7777262002,0.0,0.0,7000,7000,0
KR_7777262002,60.03,1.0,7015,7015,0
KR_7777262002,120.043,2.0,10826,10730,96
KR_7777262002,180.061,3.0,14246,14286,-40
KR_7777262002,240.091,4.0,17510,17732,-222
KR_7777262002,300.165,5.0,21033,20607,426
KR_7777262002,360.187,6.0,23601,23226,375
KR_7777262002,420.214,7.0,26974,26391,583
KR_7777262002,480.239,8.0,29966,29426,540
KR_7777262002,540.241,9.0,33703,32501,1202
KR_7777262002,600.265,10.0,37947,35827,2120
KR_7777262002,660.293,11.0,40932,40043,889
KR_7777262002,720.3,12.0,44394,42223,2171
KR_7777262002,780.307,13.01,47113,46482,631
KR_7777262002,840.308,14.01,50916,50272,644
KR_7777262002,900.312,15.01,53995,53274,721
KR_7777262002,960.341,16.01,57327,56415,912
KR_7777262002,1020.357,17.01,61039,59221,1818
KR_7777262002,1080.388,18.01,64037,62105,1932
KR_7777262002,1140.42,19.01,67173,65970,1203
KR_7777262002,1200.444,20.01,70687,68444,2243
KR_7777262002,1260.462,21.01,73109,73185,-76
KR_7777262002,1271.451,21.19,73735,74379,-644
KR_7763383926,0.0,0.0,7000,7000,0
KR_7763383926,60.027,1.0,7015,7015,0
KR_7763383926,120.054,2.0,9853,9303,550
KR_7763383926,180.113,3.0,12765,12580,185
KR_7763383926,240.134,4.0,17273,16508,765
KR_7763383926,300.136,5.0,20678,19893,785
KR_7763383926,360.166,6.0,23434,24350,-916
KR_7763383926,420.194,7.0,29267,26554,2713
KR_7763383926,480.213,8.0,33213,31120,2093
KR_7763383926,540.221,9.0,35869,35639,230
KR_7763383926,600.244,10.0,39805,38704,1101
KR_7763383926,660.264,11.0,43309,42085,1224
KR_7763383926,720.276,12.0,46178,45311,867
KR_7763383926,780.284,13.0,49575,48885,690
KR_7763383926,840.31,14.01,52841,52426,415
KR_7763383926,900.321,15.01,55772,55956,-184
KR_7763383926,960.348,16.01,59460,59767,-307
KR_7763383926,1020.379,17.01,63866,63096,770
KR_7763383926,1080.397,18.01,66703,66749,-46
KR_7763383926,1140.401,19.01,69867,69895,-28
KR_7763383926,1194.595,19.91,72419,73360,-941
KR_7740152052,0.0,0.0,7000,7000,0
KR_7740152052,60.014,1.0,7015,7547,-532
KR_7740152052,120.036,2.0,10221,10779,-558
KR_7740152052,180.124,3.0,13224,13617,-393
KR_7740152052,240.152,4.0,15805,16091,-286
KR_7740152052,300.171,5.0,19149,21071,-1922
KR_7740152052,360.175,6.0,22246,25561,-3315
KR_7740152052,420.195,7.0,25143,29627,-4484
KR_7740152052,480.199,8.0,29838,32589,-2751
KR_7740152052,540.223,9.0,32020,36776,-4756
KR_7740152052,600.227,10.0,36076,40075,-3999
KR_7740152052,660.251,11.0,38692,45072,-6380
KR_7740152052,720.26,12.0,41109,47558,-6449
KR_7740152052,745.021,12.42,42172,49452,-7280
KR_7765943744,0.0,0.0,7000,7000,0
KR_7765943744,60.022,1.0,7025,7015,10
KR_7765943744,120.043,2.0,9338,9338,0
KR_7765943744,180.119,3.0,11966,11751,215
KR_7765943744,240.138,4.0,14345,14192,153
KR_7765943744,300.153,5.0,17643,17066,577
KR_7765943744,360.173,6.0,21101,21397,-296
KR_7765943744,420.216,7.0,24563,24417,146
KR_7765943744,480.236,8.0,27103,26980,123
KR_7765943744,540.255,9.0,30719,29641,1078
KR_7765943744,600.258,10.0,34172,33414,758
KR_7765943744,660.284,11.0,37777,36980,797
KR_7765943744,720.308,12.01,40500,39370,1130
KR_7765943744,780.318,13.01,43906,42289,1617
KR_7765943744,840.343,14.01,47109,45933,1176
KR_7765943744,900.364,15.01,49817,48471,1346
KR_7765943744,960.396,16.01,53874,51838,2036
KR_7765943744,1020.41,17.01,56166,54597,1569
KR_7765943744,1080.436,18.01,58881,57838,1043
KR_7765943744,1140.441,19.01,62572,61259,1313
KR_7765943744,1200.446,20.01,65094,63674,1420
KR_7765943744,1260.47,21.01,67550,66731,819
KR_7765943744,1320.49,22.01,70829,70313,516
KR_7765943744,1380.514,23.01,73518,74131,-613
KR_7765943744,1440.537,24.01,78448,76579,1869
KR_7765943744,1500.56,25.01,81303,82236,-933
KR_7765943744,1560.571,26.01,84128,84827,-699
KR_7765943744,1620.586,27.01,87841,87471,370
KR_7765943744,1680.611,28.01,91099,90404,695
KR_7765943744,1740.637,29.01,93922,93598,324
KR_7765943744,1800.662,30.01,97602,96274,1328
KR_7765943744,1840.138,30.67,102220,97770,4450
KR_7740268308,0.0,0.0,7000,7000,0
KR_7740268308,60.006,1.0,7755,7368,387
KR_7740268308,120.036,2.0,11599,9764,1835
KR_7740268308,180.106,3.0,14282,12208,2074
KR_7740268308,240.131,4.0,17354,15893,1461
KR_7740268308,300.137,5.0,20699,18232,2467
KR_7740268308,360.147,6.0,23701,20879,2822
KR_7740268308,420.158,7.0,25988,23747,2241
KR_7740268308,480.186,8.0,30234,25822,4412
KR_7740268308,540.202,9.0,34470,31599,2871
KR_7740268308,600.227,10.0,36939,34391,2548
KR_7740268308,660.238,11.0,40449,36516,3933
KR_7740268308,660.872,11.01,40464,36531,3933
KR_7756538668,0.0,0.0,7000,7000,0
KR_7756538668,60.002,1.0,7015,7015,0
KR_7756538668,120.031,2.0,9809,9796,13
KR_7756538668,180.087,3.0,12250,12227,23
KR_7756538668,240.109,4.0,15764,15867,-103
KR_7756538668,300.123,5.0,18532,19068,-536
KR_7756538668,360.155,6.0,22069,22210,-141
KR_7756538668,420.169,7.0,25387,26179,-792
KR_7756538668,480.193,8.0,28938,30240,-1302
KR_7756538668,540.209,9.0,33417,33202,215
KR_7756538668,600.233,10.0,37057,36677,380
KR_7756538668,660.247,11.0,39648,40036,-388
KR_7756538668,720.27,12.0,43491,43180,311
KR_7756538668,780.291,13.0,46204,47745,-1541
KR_7756538668,840.314,14.01,50644,50682,-38
KR_7756538668,900.341,15.01,54060,53777,283
KR_7756538668,960.362,16.01,57058,57390,-332
KR_7756538668,1016.511,16.94,61087,59891,1196
KR_7767040149,0.0,0.0,7000,7000,0
KR_7767040149,60.03,1.0,7025,7015,10
KR_7767040149,120.046,2.0,10192,9304,888
KR_7767040149,180.12,3.0,12886,12492,394
KR_7767040149,240.147,4.0,17181,15967,1214
KR_7767040149,300.15,5.0,19827,18834,993
KR_7767040149,360.17,6.0,22910,22258,652
KR_7767040149,420.183,7.0,25463,26961,-1498
KR_7767040149,480.204,8.0,29540,29760,-220
KR_7767040149,540.234,9.0,32058,33274,-1216
KR_7767040149,600.259,10.0,35560,35658,-98
KR_7767040149,660.283,11.0,38464,38507,-43
KR_7767040149,720.307,12.01,41175,41686,-511
KR_7767040149,780.333,13.01,45820,44660,1160
KR_7767040149,840.365,14.01,48636,48064,572
KR_7767040149,900.374,15.01,51422,51991,-569
KR_7767040149,960.407,16.01,54812,55043,-231
KR_7767040149,1020.411,17.01,57040,58458,-1418
KR_7767040149,1080.432,18.01,60982,61419,-437
KR_7767040149,1140.462,19.01,64485,64589,-104
KR_7767040149,1200.49,20.01,67504,67907,-403
KR_7767040149,1260.52,21.01,70535,70297,238
KR_7767040149,1320.529,22.01,73088,73715,-627
KR_7767040149,1380.546,23.01,75918,76910,-992
KR_7767040149,1422.965,23.72,77915,80861,-2946
KR_7778166748,0.0,0.0,7000,7000,0
KR_7778166748,60.022,1.0,7368,7805,-437
KR_7778166748,120.055,2.0,10004,11174,-1170
KR_7778166748,180.142,3.0,13431,13990,-559
KR_7778166748,240.161,4.0,15721,17404,-1683
KR_7778166748,300.184,5.0,18239,20760,-2521
KR_7778166748,360.205,6.0,22432,23472,-1040
KR_7778166748,420.236,7.0,26380,26473,-93
KR_7778166748,480.259,8.0,29300,29510,-210
KR_7778166748,540.287,9.0,34249,32510,1739
KR_7778166748,600.318,10.01,36842,35885,957
KR_7778166748,660.332,11.01,40701,38146,2555
KR_7778166748,720.342,12.01,43228,40652,2576
KR_7778166748,780.359,13.01,46374,45720,654
KR_7778166748,840.39,14.01,51223,48474,2749
KR_7778166748,900.421,15.01,53825,51242,2583
KR_7778166748,960.435,16.01,56227,55497,730
KR_7778166748,1020.443,17.01,59153,57749,1404
KR_7778166748,1080.455,18.01,63674,60300,3374
KR_7778166748,1117.582,18.63,66232,61959,4273
KR_7739025569,0.0,0.0,7000,7000,0
KR_7739025569,60.004,1.0,7015,7018,-3
KR_7739025569,120.011,2.0,9492,10791,-1299
KR_7739025569,180.025,3.0,13816,13697,119
KR_7739025569,240.031,4.0,17882,17511,371
KR_7739025569,300.121,5.0,21515,21066,449
KR_7739025569,360.137,6.0,24879,23987,892
KR_7739025569,420.146,7.0,28244,27339,905
KR_7739025569,480.162,8.0,31472,30941,531
KR_7739025569,540.174,9.0,35078,33822,1256
KR_7739025569,600.184,10.0,37765,37938,-173
KR_7739025569,660.229,11.0,41036,40530,506
KR_7739025569,720.254,12.0,44752,44410,342
KR_7739025569,780.263,13.0,47682,48108,-426
KR_7739025569,840.273,14.0,50293,51266,-973
KR_7739025569,900.277,15.0,53490,53939,-449
KR_7739025569,960.292,16.0,57885,56360,1525
KR_7739025569,1020.313,17.01,60053,60464,-411
KR_7739025569,1080.345,18.01,63597,64259,-662
KR_7739025569,1140.356,19.01,66004,67036,-1032
KR_7739025569,1200.388,20.01,68733,70310,-1577
KR_7739025569,1260.417,21.01,72251,73269,-1018
KR_7739025569,1320.441,22.01,74796,77216,-2420
KR_7739025569,1380.473,23.01,77617,82015,-4398
KR_7739025569,1440.491,24.01,81003,85185,-4182
KR_7739025569,1485.438,24.76,82638,88233,-5595
KR_7777970180,0.0,0.0,7000,7000,0
KR_7777970180,60.007,1.0,7015,7025,-10
KR_7777970180,120.033,2.0,9665,10126,-461
KR_7777970180,180.099,3.0,13712,13845,-133
KR_7777970180,240.126,4.0,16678,17917,-1239
KR_7777970180,300.153,5.0,19702,21352,-1650
KR_7777970180,360.174,6.0,23007,24569,-1562
KR_7777970180,420.193,7.0,27301,27485,-184
KR_7777970180,480.217,8.0,30162,30137,25
KR_7777970180,540.222,9.0,32629,33853,-1224
KR_7777970180,600.245,10.0,38024,36799,1225
KR_7777970180,660.257,11.0,41263,39108,2155
KR_7777970180,720.282,12.0,45053,43872,1181
KR_7777970180,780.309,13.01,48982,47445,1537
KR_7777970180,840.33,14.01,51465,50272,1193
KR_7777970180,900.34,15.01,55642,52724,2918
KR_7777970180,960.353,16.01,58389,56010,2379
KR_7777970180,1018.695,16.98,63338,58952,4386
KR_7625441793,0.0,0.0,7000,7000,0
KR_7625441793,60.002,1.0,7845,7539,306
KR_7625441793,120.029,2.0,11348,11424,-76
KR_7625441793,180.114,3.0,14634,14617,17
KR_7625441793,240.114,4.0,18626,18992,-366
KR_7625441793,300.148,5.0,22497,22095,402
KR_7625441793,360.171,6.0,26183,24987,1196
KR_7625441793,420.19,7.0,30382,27511,2871
KR_7625441793,480.221,8.0,32956,31861,1095
KR_7625441793,540.227,9.0,36621,34750,1871
KR_7625441793,600.258,10.0,39254,38540,714
KR_7625441793,660.285,11.0,42439,41702,737
KR_7625441793,720.306,12.01,45213,46244,-1031
KR_7625441793,780.329,13.01,48880,49036,-156
KR_7625441793,840.334,14.01,52287,52750,-463
KR_7625441793,900.367,15.01,56352,55540,812
KR_7625441793,960.389,16.01,58732,58998,-266
KR_7625441793,1020.397,17.01,60914,63784,-2870
KR_7625441793,1080.407,18.01,64547,67339,-2792
KR_7625441793,1140.413,19.01,66916,70910,-3994
KR_7625441793,1175.267,19.59,68296,73833,-5537
KR_7628202278,0.0,0.0,7000,7000,0
KR_7628202278,60.018,1.0,7015,7015,0
KR_7628202278,120.036,2.0,9841,9535,306
KR_7628202278,180.086,3.0,12925,11916,1009
KR_7628202278,240.102,4.0,15442,15025,417
KR_7628202278,300.158,5.0,19015,18502,513
KR_7628202278,360.174,6.0,21960,21707,253
KR_7628202278,420.192,7.0,25803,24010,1793
KR_7628202278,480.209,8.0,28809,26607,2202
KR_7628202278,540.237,9.0,31435,30173,1262
KR_7628202278,600.253,10.0,34545,33835,710
KR_7628202278,660.27,11.0,36891,36374,517
KR_7628202278,720.285,12.0,41902,39068,2834
KR_7628202278,780.303,13.01,44253,42910,1343
KR_7628202278,840.318,14.01,47681,44978,2703
KR_7628202278,900.332,15.01,51034,48669,2365
KR_7628202278,960.346,16.01,54444,52355,2089
KR_7628202278,1020.359,17.01,56724,55590,1134
KR_7628202278,1080.388,18.01,59736,58168,1568
KR_7628202278,1140.419,19.01,62034,61776,258
KR_7628202278,1200.432,20.01,64481,64240,241
KR_7628202278,1260.453,21.01,69511,66582,2929
KR_7628202278,1320.479,22.01,73580,69686,3894
KR_7628202278,1380.48,23.01,76600,72750,3850
KR_7628202278,1440.507,24.01,79416,75899,3517
KR_7628202278,1500.517,25.01,82802,79087,3715
KR_7628202278,1506.862,25.11,83068,79267,3801
KR_7776683624,0.0,0.0,7000,7000,0
KR_7776683624,60.024,1.0,7015,7015,0
KR_7776683624,120.031,2.0,10231,9523,708
KR_7776683624,180.05,3.0,13759,13553,206
KR_7776683624,240.07,4.0,17887,16027,1860
KR_7776683624,300.154,5.0,21557,18793,2764
KR_7776683624,360.155,6.0,24908,23170,1738
KR_7776683624,420.207,7.0,27991,26301,1690
KR_7776683624,480.237,8.0,32436,29105,3331
KR_7776683624,540.263,9.0,34932,33400,1532
KR_7776683624,600.295,10.0,38382,36517,1865
KR_7776683624,660.307,11.01,42882,39704,3178
KR_7776683624,720.328,12.01,45156,42738,2418
KR_7776683624,742.672,12.38,47148,43514,3634
KR_7644345703,0.0,0.0,7000,7000,0
KR_7644345703,60.03,1.0,7015,7419,-404
KR_7644345703,120.046,2.0,9955,10838,-883
KR_7644345703,180.116,3.0,12961,14280,-1319
KR_7644345703,240.134,4.0,16723,17355,-632
KR_7644345703,300.135,5.0,20066,21473,-1407
KR_7644345703,360.154,6.0,22792,23994,-1202
KR_7644345703,420.17,7.0,25890,26919,-1029
KR_7644345703,480.189,8.0,29246,30322,-1076
KR_7644345703,540.202,9.0,32107,32867,-760
KR_7644345703,600.22,10.0,35318,36708,-1390
KR_7644345703,660.225,11.0,38546,39237,-691
KR_7644345703,720.245,12.0,41739,43377,-1638
KR_7644345703,780.259,13.0,43998,47202,-3204
KR_7644345703,840.288,14.0,46624,51834,-5210
KR_7644345703,900.296,15.0,51147,55004,-3857
KR_7644345703,960.298,16.0,53468,60514,-7046
KR_7644345703,967.111,16.12,53663,60759,-7096
KR_7767366341,0.0,0.0,7000,7000,0
KR_7767366341,60.013,1.0,7437,7015,422
KR_7767366341,120.046,2.0,11598,11312,286
KR_7767366341,180.109,3.0,14607,14128,479
KR_7767366341,240.139,4.0,18656,17217,1439
KR_7767366341,300.165,5.0,21983,22289,-306
KR_7767366341,360.185,6.0,24847,24601,246
KR_7767366341,420.214,7.0,29228,28577,651
KR_7767366341,480.237,8.0,33422,31510,1912
KR_7767366341,540.264,9.0,36516,36069,447
KR_7767366341,600.284,10.0,40582,39255,1327
KR_7767366341,660.294,11.0,43945,43473,472
KR_7767366341,720.315,12.01,46650,45536,1114
KR_7767366341,780.322,13.01,48847,49505,-658
KR_7767366341,840.348,14.01,52681,52404,277
KR_7767366341,900.37,15.01,56182,55099,1083
KR_7767366341,960.37,16.01,59313,57683,1630
KR_7767366341,1020.376,17.01,62832,61478,1354
KR_7767366341,1080.38,18.01,65665,63879,1786
KR_7767366341,1140.392,19.01,68767,67891,876
KR_7767366341,1200.417,20.01,72352,70181,2171
KR_7767366341,1215.614,20.26,74146,70951,3195
KR_7743731507,0.0,0.0,7000,7000,0
KR_7743731507,60.008,1.0,8186,7373,813
KR_7743731507,120.035,2.0,12108,11241,867
KR_7743731507,180.123,3.0,15912,14610,1302
KR_7743731507,240.125,4.0,18780,17626,1154
KR_7743731507,300.165,5.0,22766,21165,1601
KR_7743731507,360.192,6.0,26162,24330,1832
KR_7743731507,420.214,7.0,29483,29080,403
KR_7743731507,480.239,8.0,33968,31827,2141
KR_7743731507,540.249,9.0,37007,36368,639
KR_7743731507,600.257,10.0,39938,40049,-111
KR_7743731507,660.287,11.0,44155,42678,1477
KR_7743731507,720.295,12.0,47391,45901,1490
KR_7743731507,780.306,13.01,50417,48168,2249
KR_7743731507,840.33,14.01,54443,51951,2492
KR_7743731507,900.361,15.01,56916,54124,2792
KR_7743731507,959.99,16.0,62051,56673,5378
KR_7778923210,0.0,0.0,7000,7000,0
KR_7778923210,60.028,1.0,7023,7427,-404
KR_7778923210,120.03,2.0,9284,10059,-775
KR_7778923210,180.05,3.0,11684,12424,-740
KR_7778923210,240.082,4.0,14204,14804,-600
KR_7778923210,300.151,5.0,16915,17863,-948
KR_7778923210,360.171,6.0,20640,20794,-154
KR_7778923210,420.172,7.0,24485,25616,-1131
KR_7778923210,480.178,8.0,28002,28388,-386
KR_7778923210,540.189,9.0,31511,32057,-546
KR_7778923210,600.205,10.0,33923,35647,-1724
KR_7778923210,660.218,11.0,37198,38713,-1515
KR_7778923210,720.231,12.0,39933,42067,-2134
KR_7778923210,780.235,13.0,42464,44831,-2367
KR_7778923210,840.246,14.0,46013,48039,-2026
KR_7778923210,900.255,15.0,48447,51641,-3194
KR_7778923210,944.163,15.74,50690,54352,-3662
KR_7683483039,0.0,0.0,7000,7000,0
KR_7683483039,60.018,1.0,7015,7015,0
KR_7683483039,120.039,2.0,9542,10204,-662
KR_7683483039,180.05,3.0,11854,13150,-1296
KR_7683483039,240.074,4.0,15693,16631,-938
KR_7683483039,300.118,5.0,19080,20491,-1411
KR_7683483039,360.151,6.0,21869,22824,-955
KR_7683483039,420.161,7.0,25369,26703,-1334
KR_7683483039,480.173,8.0,28145,30163,-2018
KR_7683483039,540.185,9.0,30655,32416,-1761
KR_7683483039,600.207,10.0,33292,35370,-2078
KR_7683483039,660.221,11.0,37502,38899,-1397
KR_7683483039,720.241,12.0,40611,42086,-1475
KR_7683483039,780.243,13.0,44524,44518,6
KR_7683483039,840.254,14.0,47327,46993,334
KR_7683483039,900.286,15.0,50211,50715,-504
KR_7683483039,960.302,16.01,53410,53475,-65
KR_7683483039,1020.322,17.01,55738,56949,-1211
KR_7683483039,1080.342,18.01,60659,58965,1694
KR_7683483039,1140.375,19.01,63875,62457,1418
KR_7683483039,1200.387,20.01,66470,64744,1726
KR_7683483039,1260.392,21.01,70401,67467,2934
KR_7683483039,1265.802,21.1,70616,67632,2984
KR_7743976781,0.0,0.0,7000,7000,0
KR_7743976781,60.03,1.0,7015,7015,0
KR_7743976781,120.057,2.0,10155,10415,-260
KR_7743976781,180.152,3.0,12589,13148,-559
KR_7743976781,240.175,4.0,16207,16294,-87
KR_7743976781,300.181,5.0,19687,20239,-552
KR_7743976781,360.199,6.0,22374,24065,-1691
KR_7743976781,420.206,7.0,26720,27240,-520
KR_7743976781,480.227,8.0,29514,30889,-1375
KR_7743976781,540.245,9.0,32979,33790,-811
KR_7743976781,600.274,10.0,36417,36794,-377
KR_7743976781,660.302,11.01,39323,39717,-394
KR_7743976781,720.308,12.01,42601,43467,-866
KR_7743976781,780.314,13.01,45315,46152,-837
KR_7743976781,840.319,14.01,47780,48479,-699
KR_7743976781,900.348,15.01,52708,50888,1820
KR_7743976781,960.372,16.01,55285,54109,1176
KR_7743976781,1020.4,17.01,58197,57724,473
KR_7743976781,1080.419,18.01,61646,61444,202
KR_7743976781,1140.42,19.01,65141,64302,839
KR_7743976781,1158.355,19.31,67228,64842,2386
KR_7770170588,0.0,0.0,7000,7000,0
KR_7770170588,60.015,1.0,7015,7048,-33
KR_7770170588,120.044,2.0,10695,9968,727
KR_7770170588,180.134,3.0,13453,13305,148
KR_7770170588,240.155,4.0,17217,16165,1052
KR_7770170588,300.159,5.0,20145,19751,394
KR_7770170588,360.179,6.0,24158,24077,81
KR_7770170588,420.191,7.0,28252,27584,668
KR_7770170588,480.21,8.0,30883,29943,940
KR_7770170588,540.231,9.0,35333,33025,2308
KR_7770170588,600.24,10.0,38805,35877,2928
KR_7770170588,660.268,11.0,41583,39687,1896
KR_7770170588,720.299,12.0,44650,42142,2508
KR_7770170588,780.317,13.01,47048,44667,2381
KR_7770170588,840.332,14.01,51332,47472,3860
KR_7770170588,900.351,15.01,54664,50995,3669
KR_7770170588,960.358,16.01,57616,53566,4050
KR_7770170588,1020.373,17.01,60414,56226,4188
KR_7770170588,1068.245,17.8,64733,58164,6569
KR_7778798017,0.0,0.0,7000,7000,0
KR_7778798017,60.003,1.0,7418,7427,-9
KR_7778798017,120.026,2.0,10379,9965,414
KR_7778798017,180.11,3.0,13487,13511,-24
KR_7778798017,240.132,4.0,16733,16423,310
KR_7778798017,300.141,5.0,21362,19913,1449
KR_7778798017,360.164,6.0,24676,23289,1387
KR_7778798017,420.179,7.0,29025,27425,1600
KR_7778798017,480.18,8.0,32207,31655,552
KR_7778798017,540.195,9.0,36448,35145,1303
KR_7778798017,600.218,10.0,38771,37869,902
KR_7778798017,660.25,11.0,41414,41858,-444
KR_7778798017,720.278,12.0,44490,45180,-690
KR_7778798017,780.299,13.0,48240,48407,-167
KR_7778798017,840.326,14.01,50617,52851,-2234
KR_7778798017,900.351,15.01,55485,56076,-591
KR_7778798017,960.378,16.01,58051,59711,-1660
KR_7778798017,1020.387,17.01,61187,62356,-1169
KR_7778798017,1068.516,17.81,62738,65544,-2806
KR_7769861873,0.0,0.0,7000,7000,0
KR_7769861873,60.014,1.0,7015,7015,0
KR_7769861873,120.024,2.0,10665,9865,800
KR_7769861873,180.037,3.0,13595,13071,524
KR_7769861873,240.058,4.0,17325,16441,884
KR_7769861873,300.137,5.0,19543,19081,462
KR_7769861873,360.149,6.0,23280,23154,126
KR_7769861873,420.161,7.0,26695,26422,273
KR_7769861873,480.186,8.0,29722,30127,-405
KR_7769861873,540.214,9.0,32467,32499,-32
KR_7769861873,600.222,10.0,36448,35514,934
KR_7769861873,660.234,11.0,39034,39655,-621
KR_7769861873,720.234,12.0,42286,42916,-630
KR_7769861873,780.266,13.0,45065,46873,-1808
KR_7769861873,840.271,14.0,48254,49839,-1585
KR_7769861873,900.273,15.0,51212,53717,-2505
KR_7769861873,960.295,16.0,54791,57910,-3119
KR_7769861873,1020.318,17.01,57443,60959,-3516
KR_7769861873,1080.335,18.01,61375,64203,-2828
KR_7769861873,1140.354,19.01,63582,67721,-4139
KR_7769861873,1154.362,19.24,64340,69025,-4685
KR_7755276121,0.0,0.0,7000,7000,0
KR_7755276121,60.026,1.0,7015,7015,0
KR_7755276121,120.033,2.0,9938,10305,-367
KR_7755276121,180.114,3.0,13850,13392,458
KR_7755276121,240.13,4.0,16717,16763,-46
KR_7755276121,300.161,5.0,20878,20722,156
KR_7755276121,360.178,6.0,23334,24947,-1613
KR_7755276121,420.194,7.0,27447,28333,-886
KR_7755276121,480.199,8.0,30450,31191,-741
KR_7755276121,540.206,9.0,33227,35030,-1803
KR_7755276121,600.221,10.0,36037,38210,-2173
KR_7755276121,660.249,11.0,38675,42331,-3656
KR_7755276121,720.279,12.0,41866,46101,-4235
KR_7755276121,780.286,13.0,45332,49404,-4072
KR_7755276121,840.304,14.01,48826,53091,-4265
KR_7755276121,900.317,15.01,51776,56988,-5212
KR_7755276121,960.337,16.01,55473,60166,-4693
KR_7755276121,1020.352,17.01,59585,63391,-3806
KR_7755276121,1080.356,18.01,63440,65379,-1939
KR_7755276121,1140.366,19.01,66680,68839,-2159
KR_7755276121,1200.37,20.01,69577,72893,-3316
KR_7755276121,1260.37,21.01,71872,76216,-4344
KR_7755276121,1320.398,22.01,74462,78789,-4327
KR_7755276121,1380.422,23.01,78544,83211,-4667
KR_7755276121,1440.429,24.01,80934,86238,-5304
KR_7755276121,1500.443,25.01,85050,89571,-4521
KR_7755276121,1560.449,26.01,88412,93173,-4761
KR_7755276121,1605.73,26.76,90765,97033,-6268
KR_7741999399,0.0,0.0,7000,7000,0
KR_7741999399,60.029,1.0,7025,7015,10
KR_7741999399,120.053,2.0,10165,10731,-566
KR_7741999399,180.121,3.0,13524,14122,-598
KR_7741999399,240.126,4.0,16997,17284,-287
KR_7741999399,300.147,5.0,19628,20289,-661
KR_7741999399,360.168,6.0,22648,23678,-1030
KR_7741999399,420.185,7.0,26718,27144,-426
KR_7741999399,480.208,8.0,29539,30587,-1048
KR_7741999399,540.228,9.0,33111,35285,-2174
KR_7741999399,600.255,10.0,35245,39512,-4267
KR_7741999399,660.263,11.0,39713,41663,-1950
KR_7741999399,720.28,12.0,43676,45598,-1922
KR_7741999399,780.297,13.0,46691,48356,-1665
KR_7741999399,840.319,14.01,49114,51295,-2181
KR_7741999399,900.333,15.01,53568,53287,281
KR_7741999399,960.353,16.01,56327,57291,-964
KR_7741999399,1020.373,17.01,59277,60691,-1414
KR_7741999399,1080.404,18.01,62132,63895,-1763
KR_7741999399,1140.43,19.01,65522,67171,-1649
KR_7741999399,1200.447,20.01,67821,70419,-2598
KR_7741999399,1232.645,20.54,69429,73288,-3859
KR_7712845468,0.0,0.0,7000,7000,0
KR_7712845468,60.032,1.0,7015,7020,-5
KR_7712845468,120.044,2.0,9650,9677,-27
KR_7712845468,180.105,3.0,12423,12410,13
KR_7712845468,240.128,4.0,14924,15187,-263
KR_7712845468,300.161,5.0,17858,17720,138
KR_7712845468,360.163,6.0,21617,20850,767
KR_7712845468,420.195,7.0,24233,23708,525
KR_7712845468,480.197,8.0,26752,27229,-477
KR_7712845468,540.202,9.0,30057,30093,-36
KR_7712845468,600.211,10.0,34034,33147,887
KR_7712845468,660.22,11.0,37574,36788,786
KR_7712845468,720.246,12.0,41368,39979,1389
KR_7712845468,780.278,13.0,44460,43371,1089
KR_7712845468,840.304,14.01,47764,46264,1500
KR_7712845468,900.323,15.01,50479,49563,916
KR_7712845468,960.346,16.01,53388,52443,945
KR_7712845468,1020.36,17.01,56830,54788,2042
KR_7712845468,1080.367,18.01,60674,58524,2150
KR_7712845468,1140.399,19.01,63427,61132,2295
KR_7712845468,1200.409,20.01,67256,64575,2681
KR_7712845468,1260.41,21.01,69682,67724,1958
KR_7712845468,1320.437,22.01,72001,70692,1309
KR_7712845468,1380.439,23.01,73971,76031,-2060
KR_7712845468,1423.14,23.72,77237,77306,-69
KR_7765862550,0.0,0.0,7000,7000,0
KR_7765862550,60.001,1.0,7487,7283,204
KR_7765862550,120.021,2.0,10030,10127,-97
KR_7765862550,180.023,3.0,12273,13888,-1615
KR_7765862550,240.044,4.0,15794,17804,-2010
KR_7765862550,300.099,5.0,18934,21285,-2351
KR_7765862550,360.124,6.0,22922,25016,-2094
KR_7765862550,420.143,7.0,25401,29354,-3953
KR_7765862550,480.163,8.0,28592,32357,-3765
KR_7765862550,540.195,9.0,33759,34774,-1015
KR_7765862550,600.217,10.0,37138,37932,-794
KR_7765862550,660.234,11.0,39333,41590,-2257
KR_7765862550,720.259,12.0,43077,45189,-2112
KR_7765862550,780.283,13.0,47959,47977,-18
KR_7765862550,840.305,14.01,50727,52050,-1323
KR_7765862550,900.309,15.01,53208,55698,-2490
KR_7765862550,945.807,15.76,57623,57382,241
KR_7775300382,0.0,0.0,7000,7000,0
KR_7775300382,60.022,1.0,7025,7427,-402
KR_7775300382,120.025,2.0,10853,10136,717
KR_7775300382,180.042,3.0,14753,13290,1463
KR_7775300382,240.068,4.0,18006,16969,1037
KR_7775300382,300.132,5.0,21621,19815,1806
KR_7775300382,360.158,6.0,24692,23499,1193
KR_7775300382,420.185,7.0,28473,26773,1700
KR_7775300382,480.208,8.0,31777,29908,1869
KR_7775300382,540.237,9.0,34886,33228,1658
KR_7775300382,589.067,9.82,39070,35423,3647
KR_7721908875,0.0,0.0,7000,7000,0
KR_7721908875,60.016,1.0,8147,7015,1132
KR_7721908875,120.025,2.0,11324,11813,-489
KR_7721908875,180.042,3.0,14453,14336,117
KR_7721908875,240.049,4.0,17530,17962,-432
KR_7721908875,300.066,5.0,21458,21004,454
KR_7721908875,360.078,6.0,24281,23416,865
KR_7721908875,420.095,7.0,27377,27344,33
KR_7721908875,480.118,8.0,31727,30730,997
KR_7721908875,540.193,9.0,35108,33427,1681
KR_7721908875,600.208,10.0,38055,37260,795
KR_7721908875,660.22,11.0,40998,40658,340
KR_7721908875,720.237,12.0,44453,43757,696
KR_7721908875,780.258,13.0,47378,47709,-331
KR_7721908875,840.273,14.0,50157,50856,-699
KR_7721908875,900.286,15.0,54945,53570,1375
KR_7721908875,937.367,15.62,56473,55507,966
KR_7779559280,0.0,0.0,7000,7000,0
KR_7779559280,60.001,1.0,7015,7447,-432
KR_7779559280,120.024,2.0,9382,9708,-326
KR_7779559280,180.027,3.0,12632,12889,-257
KR_7779559280,240.054,4.0,15741,15967,-226
KR_7779559280,300.13,5.0,18439,19339,-900
KR_7779559280,360.14,6.0,23644,21732,1912
KR_7779559280,420.162,7.0,27784,25223,2561
KR_7779559280,480.169,8.0,29942,29193,749
KR_7779559280,540.18,9.0,34100,32018,2082
KR_7779559280,600.203,10.0,37420,35943,1477
KR_7779559280,660.223,11.0,40301,38238,2063
KR_7779559280,720.229,12.0,43866,42378,1488
KR_7779559280,780.254,13.0,47774,45639,2135
KR_7779559280,840.259,14.0,51494,49762,1732
KR_7779559280,900.281,15.0,54846,52335,2511
KR_7779559280,960.29,16.0,57986,56350,1636
KR_7779559280,1020.304,17.01,62587,59941,2646
KR_7779559280,1080.336,18.01,65329,63368,1961
KR_7779559280,1113.469,18.56,68069,64358,3711
KR_7773094622,0.0,0.0,7000,7000,0
KR_7773094622,60.018,1.0,7427,7015,412
KR_7773094622,120.041,2.0,10517,11187,-670
KR_7773094622,180.124,3.0,13087,13525,-438
KR_7773094622,240.153,4.0,16348,16615,-267
KR_7773094622,300.16,5.0,19451,20137,-686
KR_7773094622,360.19,6.0,22565,22625,-60
KR_7773094622,420.193,7.0,26104,25757,347
KR_7773094622,480.213,8.0,28803,29625,-822
KR_7773094622,540.226,9.0,31323,32337,-1014
KR_7773094622,600.257,10.0,34773,35815,-1042
KR_7773094622,660.266,11.0,37570,39965,-2395
KR_7773094622,720.296,12.0,42187,42791,-604
KR_7773094622,780.306,13.01,45451,45464,-13
KR_7773094622,840.325,14.01,47785,48510,-725
KR_7773094622,900.34,15.01,50567,52093,-1526
KR_7773094622,960.367,16.01,52948,54666,-1718
KR_7773094622,1020.381,17.01,56587,57194,-607
KR_7773094622,1080.403,18.01,59739,60832,-1093
KR_7773094622,1140.405,19.01,61792,64022,-2230
KR_7773094622,1200.425,20.01,65145,67343,-2198
KR_7773094622,1260.45,21.01,67973,70480,-2507
KR_7773094622,1320.462,22.01,73260,72385,875
KR_7773094622,1380.483,23.01,75182,77091,-1909
KR_7773094622,1394.444,23.24,75691,79061,-3370
KR_7734325185,0.0,0.0,7000,7000,0
KR_7734325185,60.027,1.0,7015,7015,0
KR_7734325185,120.053,2.0,9650,9668,-18
KR_7734325185,180.127,3.0,12621,14068,-1447
KR_7734325185,240.145,4.0,15925,17709,-1784
KR_7734325185,300.149,5.0,19784,20522,-738
KR_7734325185,360.17,6.0,21812,26077,-4265
KR_7734325185,420.178,7.0,25765,28171,-2406
KR_7734325185,480.197,8.0,28216,30887,-2671
KR_7734325185,540.214,9.0,32426,34547,-2121
KR_7734325185,600.234,10.0,37002,37556,-554
KR_7734325185,660.238,11.0,39258,41032,-1774
KR_7734325185,720.257,12.0,42792,44583,-1791
KR_7734325185,780.29,13.0,45166,47784,-2618
KR_7734325185,840.294,14.0,48987,51109,-2122
KR_7734325185,900.309,15.01,52461,54875,-2414
KR_7734325185,960.326,16.01,55229,57323,-2094
KR_7734325185,1020.327,17.01,57951,60624,-2673
KR_7734325185,1080.333,18.01,61486,64678,-3192
KR_7734325185,1140.335,19.01,65288,66879,-1591
KR_7734325185,1200.359,20.01,69507,69136,371
KR_7734325185,1222.333,20.37,71313,70429,884
KR_7742387726,0.0,0.0,7000,7000,0
KR_7742387726,60.015,1.0,7025,7015,10
KR_7742387726,120.03,2.0,9312,10019,-707
KR_7742387726,180.095,3.0,12516,13449,-933
KR_7742387726,240.114,4.0,15686,16110,-424
KR_7742387726,300.119,5.0,18677,18748,-71
KR_7742387726,360.138,6.0,22430,21971,459
KR_7742387726,420.163,7.0,26101,25618,483
KR_7742387726,480.185,8.0,29071,29514,-443
KR_7742387726,540.201,9.0,32349,32923,-574
KR_7742387726,600.228,10.0,35650,36044,-394
KR_7742387726,660.26,11.0,38772,39421,-649
KR_7742387726,720.265,12.0,41592,42663,-1071
KR_7742387726,780.27,13.0,44645,44883,-238
KR_7742387726,840.294,14.0,48369,48263,106
KR_7742387726,900.317,15.01,50929,52850,-1921
KR_7742387726,960.325,16.01,54162,57576,-3414
KR_7742387726,1020.342,17.01,56940,60476,-3536
KR_7742387726,1080.369,18.01,61710,62367,-657
KR_7742387726,1140.381,19.01,64590,65602,-1012
KR_7742387726,1179.692,19.66,65923,67545,-1622
KR_7773218269,0.0,0.0,7000,7000,0
KR_7773218269,60.009,1.0,7015,7015,0
KR_7773218269,120.021,2.0,9753,9921,-168
KR_7773218269,180.093,3.0,13852,14554,-702
KR_7773218269,240.126,4.0,17616,16949,667
KR_7773218269,300.145,5.0,20541,21980,-1439
KR_7773218269,360.156,6.0,24523,25845,-1322
KR_7773218269,420.177,7.0,29369,29534,-165
KR_7773218269,480.203,8.0,32056,32689,-633
KR_7773218269,540.23,9.0,35235,36930,-1695
KR_7773218269,600.237,10.0,38475,39933,-1458
KR_7773218269,660.263,11.0,42300,44232,-1932
KR_7773218269,720.285,12.0,46039,46820,-781
KR_7773218269,780.313,13.01,49490,50985,-1495
KR_7773218269,840.317,14.01,52488,53528,-1040
KR_7773218269,900.327,15.01,55444,57203,-1759
KR_7773218269,960.333,16.01,59074,60242,-1168
KR_7773218269,1020.337,17.01,62725,62941,-216
KR_7773218269,1080.369,18.01,65030,66107,-1077
KR_7773218269,1140.388,19.01,67776,70412,-2636
KR_7773218269,1200.418,20.01,70922,73257,-2335
KR_7773218269,1260.445,21.01,73610,77504,-3894
KR_7773218269,1320.461,22.01,76343,79951,-3608
KR_7773218269,1380.475,23.01,78584,85805,-7221
KR_7773218269,1381.177,23.02,78614,85835,-7221
KR_7706424300,0.0,0.0,7000,7000,0
KR_7706424300,60.013,1.0,7015,7015,0
KR_7706424300,120.032,2.0,11745,10606,1139
KR_7706424300,180.122,3.0,15292,13860,1432
KR_7706424300,240.133,4.0,19998,18009,1989
KR_7706424300,300.145,5.0,23785,20602,3183
KR_7706424300,360.178,6.0,26620,24121,2499
KR_7706424300,420.202,7.0,30785,26913,3872
KR_7706424300,480.233,8.0,34729,30767,3962
KR_7706424300,540.257,9.0,38007,33904,4103
KR_7706424300,600.266,10.0,43146,37189,5957
KR_7706424300,660.29,11.0,46817,40717,6100
KR_7706424300,720.31,12.01,50077,44352,5725
KR_7706424300,780.325,13.01,53637,47139,6498
KR_7706424300,840.353,14.01,57224,49774,7450
KR_7706424300,900.376,15.01,62348,52231,10117
KR_7706424300,923.088,15.38,63771,53483,10288
KR_7766591145,0.0,0.0,7000,7000,0
KR_7766591145,60.012,1.0,7437,7316,121
KR_7766591145,120.028,2.0,11265,10314,951
KR_7766591145,180.1,3.0,14606,14120,486
KR_7766591145,240.108,4.0,18675,17599,1076
KR_7766591145,300.149,5.0,21355,20080,1275
KR_7766591145,360.165,6.0,25379,24925,454
KR_7766591145,420.166,7.0,29624,28001,1623
KR_7766591145,480.171,8.0,32208,30584,1624
KR_7766591145,540.195,9.0,34930,34760,170
KR_7766591145,600.196,10.0,38926,37442,1484
KR_7766591145,660.224,11.0,41622,40729,893
KR_7766591145,720.252,12.0,44706,44717,-11
KR_7766591145,780.277,13.0,48920,47941,979
KR_7766591145,840.279,14.0,51348,50742,606
KR_7766591145,900.29,15.0,54181,54462,-281
KR_7766591145,960.31,16.01,57332,57513,-181
KR_7766591145,1020.334,17.01,61705,59752,1953
KR_7766591145,1029.686,17.16,63490,60037,3453
KR_7769767030,0.0,0.0,7000,7000,0
KR_7769767030,60.005,1.0,7015,7015,0
KR_7769767030,120.025,2.0,9674,9652,22
KR_7769767030,180.113,3.0,13356,13323,33
KR_7769767030,240.146,4.0,16394,16031,363
KR_7769767030,300.177,5.0,20057,20029,28
KR_7769767030,360.181,6.0,23882,23267,615
KR_7769767030,420.199,7.0,26640,26007,633
KR_7769767030,480.206,8.0,29571,30321,-750
KR_7769767030,540.23,9.0,33874,33560,314
KR_7769767030,600.259,10.0,38136,37318,818
KR_7769767030,660.264,11.0,41845,39821,2024
KR_7769767030,720.293,12.0,44146,42825,1321
KR_7769767030,780.321,13.01,46992,47036,-44
KR_7769767030,840.35,14.01,50839,49405,1434
KR_7769767030,900.365,15.01,53732,51808,1924
KR_7769767030,960.38,16.01,58012,55500,2512
KR_7769767030,1020.39,17.01,61271,57783,3488
KR_7769767030,1080.405,18.01,66303,60289,6014
KR_7769767030,1097.707,18.3,67178,61472,5706
KR_7775415978,0.0,0.0,7000,7000,0
KR_7775415978,60.029,1.0,7015,7036,-21
KR_7775415978,120.031,2.0,9166,10547,-1381
KR_7775415978,180.046,3.0,11734,13324,-1590
KR_7775415978,240.054,4.0,14012,16609,-2597
KR_7775415978,300.069,5.0,18149,19221,-1072
KR_7775415978,360.074,6.0,20425,21712,-1287
KR_7775415978,420.095,7.0,25437,25853,-416
KR_7775415978,480.102,8.0,28038,28713,-675
KR_7775415978,540.116,9.0,31324,32556,-1232
KR_7775415978,600.126,10.0,33597,35431,-1834
KR_7775415978,660.14,11.0,36734,39211,-2477
KR_7775415978,720.145,12.0,39248,41818,-2570
KR_7775415978,780.158,13.0,44332,44422,-90
KR_7775415978,840.178,14.0,47304,48014,-710
KR_7775415978,900.19,15.0,51027,50702,325
KR_7775415978,960.203,16.0,53100,54940,-1840
KR_7775415978,1020.216,17.0,57530,57675,-145
KR_7775415978,1080.228,18.0,59524,60521,-997
KR_7775415978,1140.241,19.0,63855,62795,1060
KR_7775415978,1159.486,19.32,66308,63365,2943
KR_7740216370,0.0,0.0,7000,7000,0
KR_7740216370,60.009,1.0,8807,7015,1792
KR_7740216370,120.018,2.0,12506,11114,1392
KR_7740216370,180.032,3.0,16012,13937,2075
KR_7740216370,240.054,4.0,19858,18394,1464
KR_7740216370,300.122,5.0,23841,20959,2882
KR_7740216370,360.145,6.0,27093,23989,3104
KR_7740216370,420.178,7.0,30069,26367,3702
KR_7740216370,480.2,8.0,33411,28990,4421
KR_7740216370,540.227,9.0,36212,34684,1528
KR_7740216370,600.25,10.0,39954,38273,1681
KR_7740216370,660.27,11.0,44374,42469,1905
KR_7740216370,720.288,12.0,47585,46251,1334
KR_7740216370,780.297,13.0,51253,48775,2478
KR_7740216370,840.321,14.01,53976,52569,1407
KR_7740216370,900.33,15.01,57027,54734,2293
KR_7740216370,960.339,16.01,60734,57111,3623
KR_7740216370,1020.366,17.01,63390,62931,459
KR_7740216370,1080.375,18.01,68331,64778,3553
KR_7740216370,1137.936,18.97,70184,69205,979
KR_7726192073,0.0,0.0,7000,7000,0
KR_7726192073,60.022,1.0,7015,7905,-890
KR_7726192073,120.05,2.0,10308,12344,-2036
KR_7726192073,180.13,3.0,14065,14735,-670
KR_7726192073,240.152,4.0,18294,18472,-178
KR_7726192073,300.168,5.0,21783,22271,-488
KR_7726192073,360.193,6.0,24954,25816,-862
KR_7726192073,420.208,7.0,28429,28824,-395
KR_7726192073,480.237,8.0,30638,32494,-1856
KR_7726192073,540.258,9.0,35596,36495,-899
KR_7726192073,600.289,10.0,38660,40274,-1614
KR_7726192073,660.321,11.01,41644,43673,-2029
KR_7726192073,720.352,12.01,45707,45979,-272
KR_7726192073,780.382,13.01,47864,50712,-2848
KR_7726192073,840.407,14.01,52027,52909,-882
KR_7726192073,900.412,15.01,54836,56931,-2095
KR_7726192073,960.43,16.01,58021,60557,-2536
KR_7726192073,1020.431,17.01,61225,62895,-1670
KR_7726192073,1080.45,18.01,64144,66481,-2337
KR_7726192073,1122.902,18.72,65699,70807,-5108
KR_7741863119,0.0,0.0,7000,7000,0
KR_7741863119,60.006,1.0,7470,8595,-1125
KR_7741863119,120.032,2.0,10305,12313,-2008
KR_7741863119,180.113,3.0,13447,16853,-3406
KR_7741863119,240.135,4.0,16400,20148,-3748
KR_7741863119,300.167,5.0,20235,23256,-3021
KR_7741863119,360.176,6.0,22509,26182,-3673
KR_7741863119,420.207,7.0,26054,29481,-3427
KR_7741863119,480.227,8.0,28794,32883,-4089
KR_7741863119,540.241,9.0,34305,36465,-2160
KR_7741863119,600.263,10.0,37430,40109,-2679
KR_7741863119,660.277,11.0,39739,43630,-3891
KR_7741863119,720.301,12.01,42149,46021,-3872
KR_7741863119,780.32,13.01,45899,49338,-3439
KR_7741863119,840.32,14.01,48791,52692,-3901
KR_7741863119,900.337,15.01,51662,56433,-4771
KR_7741863119,960.362,16.01,54572,60379,-5807
KR_7741863119,1020.368,17.01,56852,63202,-6350
KR_7741863119,1080.373,18.01,60390,67607,-7217
KR_7741863119,1140.373,19.01,63788,70604,-6816
KR_7741863119,1200.381,20.01,67752,73129,-5377
KR_7741863119,1260.404,21.01,71348,76033,-4685
KR_7741863119,1320.425,22.01,74728,79833,-5105
KR_7741863119,1380.429,23.01,76883,83343,-6460
KR_7741863119,1412.335,23.54,78396,85877,-7481
